Region,City,Voting Center,Religion,Voters,Actual Voters,Discarded Votes,White Cards,Eligible Votes with White Cards
البترون,اجدبرا ,مبنى البلدية - غرفة رقم 1,ماروني,353,213,1,3,212
البترون,اده ,المدرسة الرسمية - غرفة رقم 1,ماروني,301,219,0,1,219
البترون,اده ,صالة كنيسة مار سابا - غرفة رقم 2,ماروني,325,262,0,1,262
البترون,آسيا ,قاعة الكنيسة - غرفة رقم 1,ماروني,438,235,13,0,222
البترون,آسيا ,قاعة الكنيسة - غرفة رقم 2,ماروني,459,262,2,0,260
البترون,البترون ,التكميلية الرسمية المختلطة - غرفة رقم 1,ماروني,545,304,8,2,296
البترون,البترون ,التكميلية الرسمية المختلطة - غرفة رقم 2,ماروني,552,261,2,2,259
البترون,البترون ,التكميلية الرسمية المختلطة - غرفة رقم 3,ماروني,531,238,4,3,234
البترون,البترون ,التكميلية الرسمية للبنات - غرفة رقم 1,روم ارثوذكس,556,240,5,8,235
البترون,البترون ,التكميلية الرسمية للبنات - غرفة رقم 2,مختلف,572,234,12,5,222
البترون,البترون ,التكميلية الرسمية للبنات - غرفة رقم 3,مسيحي,549,228,4,0,224
البترون,البترون ,التكميلية الرسمية للبنات - غرفة رقم 4,مختلف,435,155,2,0,153
البترون,البترون ,المدرسة الثانوية - غرفة رقم 1,ماروني,527,226,4,2,222
البترون,البترون ,المدرسة الثانوية - غرفة رقم 2,ماروني,545,315,7,7,308
البترون,البترون ,المدرسة الثانوية - غرفة رقم 3,ماروني,529,259,9,1,250
البترون,البترون ,المدرسة الثانوية - غرفة رقم 4,ماروني,552,284,10,5,274
البترون,البترون ,المدرسة الثانوية - غرفة رقم 5,ماروني,563,264,6,1,258
البترون,البترون موظفون ,سراي البترون - غرفة رقم 1,مختلف,297,287,0,6,287
البترون,العلالي ,مركز نادي البلدة - غرفة رقم 1,ماروني,156,96,3,0,93
البترون,الفتاحات وحربونا ,ساحة مار جرجس - غرفة رقم 1,ماروني,129,67,2,1,65
البترون,الهري ,المدرسة الرسمية - غرفة رقم 1,سني,399,206,4,2,202
البترون,الهري ,المدرسة الرسمية - غرفة رقم 2,سني,432,201,13,3,188
البترون,بجدرفل ,المدرسة الرسمية - غرفة رقم 1,ماروني,430,302,3,0,299
البترون,بجدرفل ,المدرسة الرسمية - غرفة رقم 2,ماروني,445,305,3,2,302
البترون,بشتودار ,مدرسة البلدة - غرفة رقم 1,مختلف,373,179,6,0,173
البترون,بشعله ,مركز البلدية المستحدث في بشعلة - غرفة رقم 1,ماروني,486,271,1,1,270
البترون,بشعله ,مركز البلدية المستحدث في بشعلة - غرفة رقم 2,ماروني,468,242,1,0,241
البترون,بشعله ,مركز البلدية المستحدث في بشعلة - غرفة رقم 3,ماروني,491,268,1,0,267
البترون,بقسميا ,المدرسة الرسمية - غرفة رقم 1,ماروني,446,252,7,1,245
البترون,بقسميا ,المدرسة الرسمية - غرفة رقم 2,ماروني,474,291,3,0,288
البترون,بيت شلالا ,المدرسة الرسمية - غرفة رقم 1,ماروني,334,119,4,0,115
البترون,بيت شلالا ,المدرسة الرسمية - غرفة رقم 2,ماروني,325,138,0,0,138
البترون,تحوم ,المدرسة الرسمية - غرفة رقم 1,ماروني,441,307,5,6,302
البترون,تنورين التحتا ,تكميلية تنورين التحتا الرسمية - غرفة رقم 1,ماروني,480,255,2,3,253
البترون,تنورين التحتا ,تكميلية تنورين التحتا الرسمية - غرفة رقم 2,ماروني,506,229,6,1,223
البترون,تنورين التحتا ,تكميلية تنورين التحتا الرسمية - غرفة رقم 3,ماروني,481,262,1,3,261
البترون,تنورين التحتا ,تكميلية تنورين التحتا الرسمية - غرفة رقم 4,ماروني,514,251,0,2,251
البترون,تنورين الفوقا ,التكميلية الرسمية - غرفة رقم 1,ماروني,587,313,6,3,307
البترون,تنورين الفوقا ,التكميلية الرسمية - غرفة رقم 2,ماروني,574,302,3,4,299
البترون,تنورين الفوقا ,التكميلية الرسمية - غرفة رقم 3,ماروني,553,337,1,1,336
البترون,تنورين الفوقا ,التكميلية الرسمية - غرفة رقم 4,ماروني,523,145,0,2,145
البترون,تنورين الفوقا ,الثانوية الرسمية - غرفة رقم 1,ماروني,575,299,3,3,296
البترون,تنورين الفوقا ,الثانوية الرسمية - غرفة رقم 2,ماروني,561,336,24,2,312
البترون,تنورين الفوقا ,الثانوية الرسمية - غرفة رقم 3,ماروني,565,277,2,6,275
البترون,تنورين الفوقا ,الثانوية الرسمية - غرفة رقم 4,ماروني,528,282,1,6,281
البترون,تنورين الفوقا ,الثانوية الرسمية - غرفة رقم 5,ماروني,547,273,3,2,270
البترون,تنورين الفوقا ,الثانوية الرسمية - غرفة رقم 6,ماروني,586,308,6,5,302
البترون,تنورين الفوقا ,الثانوية الرسمية - غرفة رقم 7,ماروني,574,334,3,6,331
البترون,تولا ,المدرسة الرسمية - غرفة رقم 1,ماروني,414,221,0,1,221
البترون,جبلا ,المدرسة الرسمية - غرفة رقم 1,ماروني,254,199,0,1,199
البترون,جران ,المدرسة الرسمية - غرفة رقم 1,ماروني,533,363,6,4,357
البترون,جربتا ,صالون كنيسة مار عبدا - غرفة رقم 1,ماروني,120,83,0,0,83
البترون,حامات ,المدرسة الرسمية - غرفة رقم 1,روم ارثوذكس,456,166,0,1,166
البترون,حامات ,المدرسة الرسمية - غرفة رقم 2,روم ارثوذكس,468,198,2,5,196
البترون,حامات ,المدرسة الرسمية - غرفة رقم 3,روم ارثوذكس,454,175,4,2,171
البترون,حامات ,المدرسة الرسمية - غرفة رقم 4,روم ارثوذكس,445,197,5,0,192
البترون,حامات ,المدرسة الرسمية - غرفة رقم 5,روم ارثوذكس,422,96,0,3,96
البترون,حدتون ,صالون الكنيسة - غرفة رقم 1,ماروني,361,223,3,1,220
البترون,حردين ,المدرسة الرسمية - غرفة رقم 1,ماروني,568,130,1,0,129
البترون,حردين ,المدرسة الرسمية - غرفة رقم 2,ماروني,527,131,0,1,131
البترون,حلتا ,المدرسة الرسمية - غرفة رقم 1,ماروني,399,226,1,2,225
البترون,داعل ,بيت جاهز امام الجامع - غرفة رقم 1,شيعي,159,87,0,1,87
البترون,دريا ,صالة رعية مار نهرا - غرفة رقم 1,ماروني,471,275,3,1,272
البترون,دوق ,صالون رعية كنيسة مار مخايل - غرفة رقم 1,ماروني,216,151,0,0,151
البترون,دول إقليمية ,دول إقليمية ,مختلف,3044,2119,24,13,2095
البترون,دوما ,المدرسة الرسمية - غرفة رقم 1,روم ارثوذكس,471,245,2,1,243
البترون,دوما ,المدرسة الرسمية - غرفة رقم 2,روم ارثوذكس,482,246,2,4,244
البترون,دوما ,المدرسة الرسمية - غرفة رقم 3,روم كاثوليك,455,138,1,0,137
البترون,دوما ,المدرسة الرسمية - غرفة رقم 4,روم كاثوليك,487,150,1,1,149
البترون,دوما ,المدرسة الرسمية - غرفة رقم 5,روم ارثوذكس,462,180,2,0,178
البترون,دوما ,المدرسة الرسمية - غرفة رقم 6,روم ارثوذكس,455,214,0,5,214
البترون,دير بلا ,مركز البلدية - غرفة رقم 1,مختلف,434,201,3,2,198
البترون,دير بلا ,مركز البلدية - غرفة رقم 2,مختلف,420,199,5,1,194
البترون,راس نحاش ,المدرسة الرسمية - غرفة رقم 1,سني,537,300,7,8,293
البترون,راس نحاش ,المدرسة الرسمية - غرفة رقم 2,سني,517,267,7,13,260
البترون,راس نحاش ,المدرسة الرسمية - غرفة رقم 3,سني,534,277,9,4,268
البترون,راشا ,صالون كنيسة الرعية - غرفة رقم 1,ماروني,254,134,2,0,132
البترون,راشانا ,مركز نادي راشانا - غرفة رقم 1,ماروني,206,152,2,0,150
البترون,راشكده ,صالون كنيسة الرعية - غرفة رقم 1,ماروني,130,84,0,0,84
البترون,راشكده ,غرفة الوقف قرب الجامع - غرفة رقم 1,شيعي,527,339,3,3,336
البترون,رام ,قاعة الكنيسة - غرفة رقم 1,ماروني,219,154,1,1,153
البترون,زان ,كنيسة مار يوحنا - غرفة رقم 1,ماروني,382,206,0,3,206
البترون,زان ,كنيسة مار يوحنا - غرفة رقم 2,ماروني,386,242,0,0,242
البترون,سلعاتا ,المدرسة الرسمية - غرفة رقم 1,مسيحي,395,268,1,3,267
البترون,سمار جبيل ,صالون الكنيسة - غرفة رقم 1,ماروني,408,252,2,1,250
البترون,شاتين ,صالون كنيسة سيدة البشارة - غرفة رقم 1,ماروني,298,211,6,3,205
البترون,شاتين ,صالون كنيسة سيدة البشارة - غرفة رقم 2,ماروني,296,136,1,0,135
البترون,شاتين ,صالون كنيسة سيدة البشارة - غرفة رقم 3,ماروني,331,203,3,4,200
البترون,شاتين ,صالون كنيسة سيدة البشارة - غرفة رقم 4,ماروني,357,179,6,1,173
البترون,شبطين ,المدرسة الرسمية - غرفة رقم 1,ماروني,493,312,3,3,309
البترون,شبطين ,المدرسة الرسمية - غرفة رقم 2,ماروني,493,339,3,1,336
البترون,شكا ,التكميلية الرسمية - غرفة رقم 1,روم ارثوذكس,512,232,0,1,232
البترون,شكا ,التكميلية الرسمية - غرفة رقم 2,روم ارثوذكس,514,263,5,2,258
البترون,شكا ,التكميلية الرسمية - غرفة رقم 3,روم ارثوذكس,458,271,4,4,267
البترون,شكا ,التكميلية الرسمية - غرفة رقم 4,مختلف,519,302,12,7,290
البترون,شكا ,ثانوية شكا الرسمية - غرفة رقم 1,ماروني,484,249,1,3,248
البترون,شكا ,ثانوية شكا الرسمية - غرفة رقم 2,ماروني,548,255,3,1,252
البترون,شكا ,ثانوية شكا الرسمية - غرفة رقم 3,ماروني,525,220,1,3,219
البترون,شكا ,ثانوية شكا الرسمية - غرفة رقم 4,ماروني,524,299,3,2,296
البترون,شكا ,ثانوية شكا الرسمية - غرفة رقم 5,ماروني,548,289,10,5,279
البترون,شكا ,ثانوية شكا الرسمية - غرفة رقم 6,ماروني,526,261,1,1,260
البترون,صغار ,مركز النادي - غرفة رقم 1,ماروني,196,138,0,2,138
البترون,صورات ,بيت الكهنة - غرفة رقم 1,ماروني,415,201,2,0,199
البترون,ضهر ابو ياغي ,صالة كنيسة مار مخايل - غرفة رقم 1,ماروني,152,106,0,1,106
البترون,عبدللي ,صالون الرعية - غرفة رقم 1,ماروني,391,222,0,1,222
البترون,عبدللي ,مركز الهاتف - غرفة رقم 2,ماروني,378,192,5,1,187
البترون,عبرين ,ثانوية عبرين - غرفة رقم 1,ماروني,487,284,2,2,282
البترون,عبرين ,ثانوية عبرين - غرفة رقم 2,ماروني,457,234,0,2,234
البترون,عبرين ,ثانوية عبرين - غرفة رقم 3,ماروني,491,291,3,4,288
البترون,عبرين ,ثانوية عبرين - غرفة رقم 4,ماروني,467,249,8,1,241
البترون,عرتز ,صالة كنيسة سيدة المعونات - غرفة رقم 1,ماروني,170,104,3,3,101
البترون,عورا ,المدرسة الرسمية - غرفة رقم 1,ماروني,177,114,0,0,114
البترون,غوما ,صالون الكنيسة - غرفة رقم 1,ماروني,276,148,1,0,147
البترون,قندولا ,بيت جاهز أمام الكنيسة - غرفة رقم 1,ماروني,58,36,1,0,35
البترون,كفر حتنا ,صالة كنيسة مار شليطا - غرفة رقم 1,ماروني,364,207,5,2,202
البترون,كفر حلده ,المدرسة الرسمية - غرفة رقم 1,روم ارثوذكس,594,157,8,1,149
البترون,كفر حلده ,المدرسة الرسمية - غرفة رقم 2,روم ارثوذكس,613,186,0,1,186
البترون,كفر شليمان ,بيت جاهز امام الكنيسة - غرفة رقم 1,ماروني,73,30,0,1,30
البترون,كفر عبيدا ,المدرسة الرسمية - غرفة رقم 1,ماروني,475,325,13,3,312
البترون,كفر عبيدا ,المدرسة الرسمية - غرفة رقم 2,ماروني,486,322,2,1,320
البترون,كفر عبيدا ,المدرسة الرسمية - غرفة رقم 3,ماروني,450,306,3,3,303
البترون,كفرحي ,المدرسة الرسمية - غرفة رقم 1,ماروني,321,178,1,3,177
البترون,كفرحي ,المدرسة الرسمية - غرفة رقم 2,ماروني,323,198,9,3,189
البترون,كفور العربي ,المدرسة الرسمية - غرفة رقم 1,روم ارثوذكس,376,170,1,3,169
البترون,كفور العربي ,المدرسة الرسمية - غرفة رقم 2,روم ارثوذكس,408,197,4,3,193
البترون,كفور العربي ,مركز البلدية - غرفة رقم 1,مسيحي,365,73,1,0,72
البترون,كفور العربي ,مركز البلدية - غرفة رقم 2,مسيحي,345,79,0,2,79
البترون,كفيفان ,صالون الكنيسة - غرفة رقم 1,ماروني,426,233,3,4,230
البترون,كفيفان ,صالون الكنيسة - غرفة رقم 2,ماروني,481,276,7,5,269
البترون,كوبا ,المستوصف - غرفة رقم 1,روم ارثوذكس,428,197,0,0,197
البترون,كوبا ,المستوصف - غرفة رقم 2,روم ارثوذكس,486,252,0,2,252
البترون,كور ,المدرسة الرسمية - غرفة رقم 1,ماروني,400,311,0,0,311
البترون,كور ,المدرسة الرسمية - غرفة رقم 2,ماروني,517,344,1,4,343
البترون,مار ماما ,صالون الكنيسة - غرفة رقم 1,ماروني,143,92,0,0,92
البترون,محمرش ,المدرسة الرسمية - غرفة رقم 1,مسيحي,583,414,1,2,413
البترون,مراح الحاج ,كنيسة القرية - غرفة رقم 1,ماروني,165,78,2,0,76
البترون,مراح الزيات ,صالون الكنيسة - غرفة رقم 1,ماروني,140,86,0,0,86
البترون,مراح شديد ودير شواح ,صالة الرعية - غرفة رقم 1,ماروني,176,128,3,0,125
البترون,مسرح والبقيعة ,باحة كنيسة مار جرجس - غرفة رقم 1,ماروني,88,50,0,0,50
البترون,نحلا ,بيت جاهز أمام الكنيسة - غرفة رقم 1,ماروني,82,52,2,0,50
البترون,نيحا ,المدرسة الرسمية - غرفة رقم 1,ماروني,575,226,3,0,223
البترون,نيحا ,المدرسة الرسمية - غرفة رقم 2,ماروني,550,185,3,1,182
البترون,وجه الحجر ,المدرسة الرسمية - غرفة رقم 1,روم ارثوذكس,516,218,2,2,216
البترون,وطى حوب ,قاعة كنيسة مار انطانيوس - غرفة رقم 1,ماروني,508,309,0,2,309
البترون,وطى حوب ,قاعة كنيسة مار انطانيوس - غرفة رقم 2,ماروني,565,356,3,4,353
الشوف, دول إقليمية, دول إقليمية,مختلف,5219,3223,35,14,3188
الشوف,الباروك ,المدرسة الرسمية - غرفة رقم 1,درزي,534,293,1,2,292
الشوف,الباروك ,المدرسة الرسمية - غرفة رقم 2,درزي,538,306,7,5,299
الشوف,الباروك ,المدرسة الرسمية - غرفة رقم 3,مختلف,524,231,1,4,230
الشوف,الباروك ,المدرسة الرسمية - غرفة رقم 4,درزي,523,254,8,0,246
الشوف,الباروك ,المدرسة الرسمية - غرفة رقم 5,درزي,541,298,2,1,296
الشوف,الباروك ,المدرسة الرسمية - غرفة رقم 6,مختلف,538,288,7,2,281
الشوف,الباروك ,صالون كنيسة مار انطونيوس للروم الكاثوليك - غرفة رقم 1,مسيحي,512,182,4,1,178
الشوف,الباروك ,صالون كنيسة مار انطونيوس للروم الكاثوليك - غرفة رقم 2,مسيحي,562,155,3,1,152
الشوف,البرجين ,مدرسة البرجين الرسمية - غرفة رقم 1,سني,514,329,3,3,326
الشوف,البرجين ,مدرسة البرجين الرسمية - غرفة رقم 2,سني,549,371,13,4,358
الشوف,البرجين ,مدرسة البرجين الرسمية - غرفة رقم 3,ماروني,486,188,8,2,180
الشوف,البطال ,المدرسة الرسمية في الدبية - غرفة رقم 1,ماروني,141,86,2,0,84
الشوف,البيره ,مركز الدفاع المدني - غرفة رقم 1,ماروني,561,361,5,2,356
الشوف,البيره ,مركز الدفاع المدني - غرفة رقم 2,ماروني,555,353,16,4,337
الشوف,البيره ,مركز الدفاع المدني - غرفة رقم 3,ماروني,544,336,8,4,328
الشوف,الجاهلية ,المدرسة الرسمية - غرفة رقم 1,درزي,552,344,1,1,343
الشوف,الجاهلية ,المدرسة الرسمية - غرفة رقم 2,درزي,560,320,2,0,318
الشوف,الجاهلية ,المدرسة الرسمية - غرفة رقم 3,درزي,553,332,14,2,318
الشوف,الجاهلية ,المدرسة الرسمية - غرفة رقم 4,درزي,557,311,6,0,305
الشوف,الجاهلية ,المدرسة الرسمية - غرفة رقم 5,درزي,563,337,2,0,335
الشوف,الجليليه ,صالة الكنيسة - غرفة رقم 1,ماروني,340,168,0,2,168
الشوف,الجميليه ,صالون الكنيسة - غرفة رقم 1,مسيحي,459,197,0,0,197
الشوف,الجيه ,المدرسة الرسمية - غرفة رقم 1,ماروني,484,92,3,1,89
الشوف,الجيه ,المدرسة الرسمية - غرفة رقم 2,ماروني,551,76,2,1,74
الشوف,الجيه ,المدرسة الرسمية - غرفة رقم 3,مختلف,564,165,4,2,161
الشوف,الجيه ,المدرسة الرسمية - غرفة رقم 4,مسلم,569,357,5,2,352
الشوف,الجيه ,مدرسة مار شربل المارونية - غرفة رقم 1,ماروني,559,103,0,2,103
الشوف,الجيه ,مدرسة مار شربل المارونية - غرفة رقم 2,ماروني,556,86,4,0,82
الشوف,الجيه ,مدرسة مار شربل المارونية - غرفة رقم 3,مختلف,541,160,4,1,156
الشوف,الجيه ,مدرسة مار شربل المارونية - غرفة رقم 4,مسلم,567,361,4,2,357
الشوف,الخريبه ,المدرسة الرسمية - غرفة رقم 1,درزي,495,281,1,3,280
الشوف,الخريبه ,المدرسة الرسمية - غرفة رقم 2,مختلف,486,260,14,1,246
الشوف,الخريبه ,المدرسة الرسمية - غرفة رقم 3,درزي,521,341,4,3,337
الشوف,الخريبه ,المدرسة الرسمية - غرفة رقم 4,مختلف,508,274,0,0,274
الشوف,الدامور ,المدرسة الفنية المهنية - غرفة رقم 1,ماروني,586,268,11,2,257
الشوف,الدامور ,المدرسة الفنية المهنية - غرفة رقم 10,ماروني,576,258,0,2,258
الشوف,الدامور ,المدرسة الفنية المهنية - غرفة رقم 11,ماروني,539,243,1,2,242
الشوف,الدامور ,المدرسة الفنية المهنية - غرفة رقم 2,ماروني,589,297,2,1,295
الشوف,الدامور ,المدرسة الفنية المهنية - غرفة رقم 3,ماروني,600,286,0,1,286
الشوف,الدامور ,المدرسة الفنية المهنية - غرفة رقم 4,ماروني,592,259,1,1,258
الشوف,الدامور ,المدرسة الفنية المهنية - غرفة رقم 5,ماروني,601,234,10,0,224
الشوف,الدامور ,المدرسة الفنية المهنية - غرفة رقم 6,ماروني,556,262,1,1,261
الشوف,الدامور ,المدرسة الفنية المهنية - غرفة رقم 7,ماروني,565,259,1,5,258
الشوف,الدامور ,المدرسة الفنية المهنية - غرفة رقم 8,ماروني,547,222,0,0,222
الشوف,الدامور ,المدرسة الفنية المهنية - غرفة رقم 9,ماروني,567,263,3,2,260
الشوف,الدامور ,مبنى بلدية الدامور الجديد - غرفة رقم 1,ماروني,605,294,14,2,280
الشوف,الدامور ,مبنى بلدية الدامور الجديد - غرفة رقم 2,ماروني,607,270,2,2,268
الشوف,الدامور ,مبنى بلدية الدامور الجديد - غرفة رقم 3,ماروني,585,292,2,1,290
الشوف,الدامور ,مبنى بلدية الدامور الجديد - غرفة رقم 4,ماروني,572,262,3,0,259
الشوف,الدامور ,مبنى بلدية الدامور الجديد - غرفة رقم 5,ماروني,548,213,0,2,213
الشوف,الدامور ,مبنى بلدية الدامور الجديد - غرفة رقم 6,مسيحي,548,223,4,2,219
الشوف,الدبية ,المدرسة الرسمية سابقا الجامعة اللبنانية كلية العلوم الفرع الاول شعبة اقليم الخروب - غرفة رقم 1,ماروني,483,292,0,1,292
الشوف,الدبية ,المدرسة الرسمية سابقا الجامعة اللبنانية كلية العلوم الفرع الاول شعبة اقليم الخروب - غرفة رقم 2,ماروني,484,250,1,0,249
الشوف,الدبية ,المدرسة الرسمية سابقا الجامعة اللبنانية كلية العلوم الفرع الاول شعبة اقليم الخروب - غرفة رقم 3,ماروني,508,193,3,1,190
الشوف,الرميله ,التكميلية الرسمية - غرفة رقم 1,ماروني,506,271,5,0,266
الشوف,الرميله ,التكميلية الرسمية - غرفة رقم 2,روم كاثوليك,565,287,3,1,284
الشوف,الرميله ,التكميلية الرسمية - غرفة رقم 3,ماروني,479,279,2,0,277
الشوف,الرميله ,التكميلية الرسمية - غرفة رقم 4,ماروني,490,268,1,3,267
الشوف,الرميله ,التكميلية الرسمية - غرفة رقم 5,ماروني,514,272,4,1,268
الشوف,الزعرورية ,المدرسة الرسمية للصبيان - غرفة رقم 1,سني,563,330,5,5,325
الشوف,الزعرورية ,المدرسة الرسمية للصبيان - غرفة رقم 2,مختلف,543,299,3,4,296
الشوف,الزعرورية ,المدرسة الرسمية للصبيان - غرفة رقم 3,سني,584,419,15,3,404
الشوف,الزعرورية ,المدرسة الرسمية للصبيان - غرفة رقم 4,مختلف,575,362,12,4,350
الشوف,السمقانية ,دار البلده - غرفة رقم 1,درزي,406,240,1,3,239
الشوف,السمقانية ,دار البلده - غرفة رقم 2,درزي,442,249,1,4,248
الشوف,الشوف موظفون ,سراي بيت الدين - غرفة رقم 1,مختلف,431,372,7,7,365
الشوف,الشوف موظفون ,سراي بيت الدين - غرفة رقم 2,مختلف,422,376,41,7,335
الشوف,الشوف موظفون ,سراي بيت الدين - غرفة رقم 3,مختلف,442,393,1,8,392
الشوف,الفريديس ,دار البلدة - غرفة رقم 1,درزي,336,195,3,6,192
الشوف,الفريديس ,صالة الكنيسة - غرفة رقم 1,مسيحي,415,176,0,0,176
الشوف,الفريديس ,صالة الكنيسة - غرفة رقم 2,مسيحي,380,162,4,1,158
الشوف,الفواره ,صالون الكنيسة - غرفة رقم 2,مسيحي,446,269,4,2,265
الشوف,الكحلونية ,دار البلدة - غرفة رقم 1,درزي,478,290,4,8,286
الشوف,الكحلونية ,دار البلدة - غرفة رقم 2,درزي,517,327,2,2,325
الشوف,الكنيسة ,كنيسة البلدة - غرفة رقم 1,ماروني,531,315,1,2,314
الشوف,المحتقره دير المخلص ,دير المخلص - غرفة رقم 2,روم كاثوليك,298,102,1,2,101
الشوف,المختارة ,مدرسة كمال جنبلاط الرسمية - غرفة رقم 1,مختلف,441,235,3,2,232
الشوف,المختارة ,مدرسة كمال جنبلاط الرسمية - غرفة رقم 2,روم كاثوليك,450,154,0,0,154
الشوف,المختارة ,مدرسة كمال جنبلاط الرسمية - غرفة رقم 3,مختلف,467,221,0,0,221
الشوف,المشرف ,مبنى البلدية الجديد في المشرف - غرفة رقم 1,ماروني,401,259,1,0,258
الشوف,المطله ,مركز البلدية - غرفة رقم 1,ماروني,451,221,11,2,210
الشوف,المطله ,مركز البلدية - غرفة رقم 2,ماروني,446,233,0,1,233
الشوف,المطله ,مركز البلدية - غرفة رقم 3,ماروني,424,194,4,2,190
الشوف,المعنيه ,صالة الكنيسة - غرفة رقم 1,ماروني,358,167,1,0,166
الشوف,المغيريه ,المدرسة الرسمية - غرفة رقم 1,سني,588,372,10,2,362
الشوف,المغيريه ,المدرسة الرسمية - غرفة رقم 2,مختلف,580,367,3,8,364
الشوف,المغيريه ,المدرسة الرسمية - غرفة رقم 3,مسلم,578,361,4,6,357
الشوف,المغيريه ,المدرسة الرسمية - غرفة رقم 4,مختلف,636,391,6,9,385
الشوف,الناعمه ,المدرسة الرسمية في الناعمة - غرفة رقم 1,ماروني,533,300,3,1,297
الشوف,الناعمه ,المدرسة الرسمية في الناعمة - غرفة رقم 2,ماروني,529,298,0,1,298
الشوف,الناعمه ,المدرسة الرسمية في الناعمة - غرفة رقم 3,ماروني,534,356,9,3,347
الشوف,الناعمه ,المدرسة الرسمية في الناعمة - غرفة رقم 4,مسيحي,521,339,2,2,337
الشوف,الوردانية ,المدرسة الرسمية - غرفة رقم 1,شيعي,625,355,22,4,333
الشوف,الوردانية ,المدرسة الرسمية - غرفة رقم 2,شيعي,617,357,30,3,327
الشوف,الوردانية ,المدرسة الرسمية - غرفة رقم 3,شيعي,607,359,16,3,343
الشوف,الوردانية ,المدرسة الرسمية - غرفة رقم 4,مختلف,604,369,14,4,355
الشوف,الورهانية ,المدرسة الرسمية - غرفة رقم 1,درزي,609,337,6,8,331
الشوف,الورهانية ,المدرسة الرسمية - غرفة رقم 2,درزي,623,362,8,8,354
الشوف,باتر ,المدرسة الرسمية - غرفة رقم 1,درزي,525,291,11,2,280
الشوف,باتر ,المدرسة الرسمية - غرفة رقم 2,درزي,517,258,1,6,257
الشوف,باتر ,المدرسة الرسمية - غرفة رقم 3,درزي,549,286,1,3,285
الشوف,باتر ,المدرسة الرسمية - غرفة رقم 4,درزي,531,261,3,8,258
الشوف,بتلون ,المدرسة الرسمية - غرفة رقم 1,درزي,460,236,15,3,221
الشوف,بتلون ,المدرسة الرسمية - غرفة رقم 2,درزي,444,212,4,1,208
الشوف,بتلون ,المدرسة الرسمية - غرفة رقم 3,درزي,454,251,8,2,243
الشوف,بتلون ,المدرسة الرسمية - غرفة رقم 4,درزي,433,226,7,0,219
الشوف,برجا ,التكميلية الرسمية للبنات - غرفة رقم 1,سني,663,400,4,6,396
الشوف,برجا ,التكميلية الرسمية للبنات - غرفة رقم 2,سني,644,414,4,3,410
الشوف,برجا ,التكميلية الرسمية للبنات - غرفة رقم 3,سني,656,350,2,5,348
الشوف,برجا ,التكميلية الرسمية للبنات - غرفة رقم 4,سني,645,362,9,4,353
الشوف,برجا ,التكميلية الرسمية للبنات - غرفة رقم 5,سني,644,329,7,1,322
الشوف,برجا ,التكميلية الرسمية للبنات - غرفة رقم 6,سني,622,370,13,3,357
الشوف,برجا ,التكميلية الرسمية للبنات - غرفة رقم 7,سني,626,388,9,1,379
الشوف,برجا ,التكميلية الرسمية للبنات - غرفة رقم 8,سني,619,367,9,0,358
الشوف,برجا ,ثانوية كمال جنبلاط - غرفة رقم 1,سني,5990,365,6,5,359
الشوف,برجا ,ثانوية كمال جنبلاط - غرفة رقم 2,سني,594,315,2,2,313
الشوف,برجا ,ثانوية كمال جنبلاط - غرفة رقم 3,سني,606,331,1,4,330
الشوف,برجا ,ثانوية كمال جنبلاط - غرفة رقم 4,سني,619,397,2,2,395
الشوف,برجا ,ثانوية كمال جنبلاط - غرفة رقم 5,سني,615,356,13,3,343
الشوف,برجا ,ثانوية كمال جنبلاط - غرفة رقم 6,سني,605,350,1,1,349
الشوف,برجا ,ثانوية كمال جنبلاط - غرفة رقم 7,سني,589,339,18,5,321
الشوف,برجا ,ثانوية كمال جنبلاط - غرفة رقم 8,سني,614,326,15,6,311
الشوف,برجا ,متوسطة برجا الديماس الرسمية المختلطة - غرفة رقم 1,سني,610,309,4,2,305
الشوف,برجا ,متوسطة برجا الديماس الرسمية المختلطة - غرفة رقم 2,سني,619,346,9,3,337
الشوف,برجا ,متوسطة برجا الديماس الرسمية المختلطة - غرفة رقم 3,سني,601,341,12,2,329
الشوف,برجا ,متوسطة برجا الديماس الرسمية المختلطة - غرفة رقم 4,سني,568,320,11,2,309
الشوف,برجا ,متوسطة برجا الديماس الرسمية المختلطة - غرفة رقم 5,سني,643,415,2,2,413
الشوف,برجا ,متوسطة برجا الديماس الرسمية المختلطة - غرفة رقم 6,سني,623,402,10,1,392
الشوف,برجا ,متوسطة برجا الديماس الرسمية المختلطة - غرفة رقم 7,سني,641,368,14,1,354
الشوف,برجا ,متوسطة برجا الديماس الرسمية المختلطة - غرفة رقم 8,سني,634,399,1,1,398
الشوف,بريح ,المدرسة الرسمية - غرفة رقم 1,درزي,407,267,13,0,254
الشوف,بريح ,المدرسة الرسمية - غرفة رقم 2,درزي,409,276,1,0,275
الشوف,بريح ,المدرسة الرسمية - غرفة رقم 3,درزي,418,243,1,3,242
الشوف,بريح ,المدرسة الرسمية - غرفة رقم 4,ماروني,532,282,3,1,279
الشوف,بريح ,المدرسة الرسمية - غرفة رقم 5,ماروني,525,259,0,3,259
الشوف,بريح ,المدرسة الرسمية - غرفة رقم 6,مسيحي,509,204,7,0,197
الشوف,بسابا ,مبنى البلدية الجديد - غرفة رقم 1,سني,532,278,4,8,274
الشوف,بسابا ,مبنى البلدية الجديد - غرفة رقم 2,سني,549,332,3,14,329
الشوف,بسابا ,مبنى البلدية الجديد - غرفة رقم 3,مختلف,565,286,5,1,281
الشوف,بشتفين ,المدرسة الرسمية - غرفة رقم 1,درزي,613,375,6,4,369
الشوف,بشتفين ,المدرسة الرسمية - غرفة رقم 2,درزي,611,350,7,0,343
الشوف,بشتفين ,المدرسة الرسمية - غرفة رقم 3,درزي,623,320,4,3,316
الشوف,بطمه ,مبنى البلدية - غرفة رقم 1,مختلف,605,328,3,5,325
الشوف,بطمه ,مبنى البلدية - غرفة رقم 2,مختلف,641,325,4,3,321
الشوف,بعاصير ,المدرسة الرسمية - غرفة رقم 1,سني,643,428,2,4,426
الشوف,بعاصير ,المدرسة الرسمية - غرفة رقم 2,سني,623,429,2,3,427
الشوف,بعاصير ,المدرسة الرسمية - غرفة رقم 3,سني,593,377,2,3,375
الشوف,بعذران ,المدرسة الرسمية - غرفة رقم 1,درزي,505,265,2,5,263
الشوف,بعذران ,المدرسة الرسمية - غرفة رقم 2,مختلف,482,211,1,2,210
الشوف,بعذران ,المدرسة الرسمية - غرفة رقم 3,درزي,583,320,0,0,320
الشوف,بعذران ,المدرسة الرسمية - غرفة رقم 4,مختلف,554,251,1,1,250
الشوف,بعقلين التحتا ,تكميلية بعقلين الرسمية - غرفة رقم 1,درزي,559,256,2,0,254
الشوف,بعقلين التحتا ,تكميلية بعقلين الرسمية - غرفة رقم 2,درزي,563,285,1,2,284
الشوف,بعقلين التحتا ,تكميلية بعقلين الرسمية - غرفة رقم 3,درزي,551,221,5,0,216
الشوف,بعقلين التحتا ,تكميلية بعقلين الرسمية - غرفة رقم 4,درزي,565,267,2,2,265
الشوف,بعقلين التحتا ,تكميلية بعقلين الرسمية - غرفة رقم 5,درزي,546,217,5,0,212
الشوف,بعقلين الفوقا ,الثانوية الرسمية - غرفة رقم 1,درزي,548,273,11,3,262
الشوف,بعقلين الفوقا ,الثانوية الرسمية - غرفة رقم 2,درزي,584,257,2,2,255
الشوف,بعقلين الفوقا ,الثانوية الرسمية - غرفة رقم 3,درزي,583,285,1,3,284
الشوف,بعقلين الفوقا ,الثانوية الرسمية - غرفة رقم 4,درزي,570,246,4,4,242
الشوف,بعقلين الفوقا ,الثانوية الرسمية - غرفة رقم 5,درزي,575,270,0,2,270
الشوف,بعقلين الفوقا ,الثانوية الرسمية - غرفة رقم 6,درزي,567,240,1,1,239
الشوف,بعقلين الفوقا ,الثانوية الرسمية - غرفة رقم 7,درزي,559,259,2,3,257
الشوف,بعقلين الفوقا ,الثانوية الرسمية - غرفة رقم 8,درزي,571,239,0,1,239
الشوف,بعقلين الفوقا ,الثانوية الرسمية - غرفة رقم 9,درزي,578,240,8,3,232
الشوف,بقعاتا ,الثانوية الرسمية - غرفة رقم 3,درزي,219,127,0,1,127
الشوف,بكيفا ,كنيسة مار يوسف - غرفة رقم 1,ماروني,359,148,2,1,146
الشوف,بنويتي ,صالون الكنيسة في البلدة - غرفة رقم 1,مسيحي,347,208,3,0,205
الشوف,بيت الدين ,مبنى البلدية - غرفة رقم 1,ماروني,552,232,2,0,230
الشوف,بيت الدين ,مبنى البلدية - غرفة رقم 2,ماروني,552,189,8,0,181
الشوف,بيت الدين ,مبنى البلدية - غرفة رقم 3,مسيحي,508,126,0,0,126
الشوف,بيقون ,كنيسة بيقون - غرفة رقم 1,ماروني,493,179,1,1,178
الشوف,جباع ,دار البلدة - غرفة رقم 1,درزي,590,296,6,3,290
الشوف,جباع ,دار البلدة - غرفة رقم 2,درزي,590,336,2,2,334
الشوف,جدرا ,وادي الزينة صالون الكنيسة - غرفة رقم 1,ماروني,497,211,4,0,207
الشوف,جديدة الشوف ,الثانوية الرسمية - غرفة رقم 1,درزي,200,174,0,4,174
الشوف,جديدة الشوف ,الثانوية الرسمية - غرفة رقم 2,درزي,345,177,1,1,176
الشوف,جون ,المدرسة الرسمية - غرفة رقم 1,شيعي,589,337,12,4,325
الشوف,جون ,المدرسة الرسمية - غرفة رقم 2,روم كاثوليك,537,218,2,1,216
الشوف,جون ,المدرسة الرسمية - غرفة رقم 3,روم كاثوليك,502,195,3,1,192
الشوف,جون ,المدرسة الرسمية - غرفة رقم 4,شيعي,548,297,8,2,289
الشوف,جون ,المدرسة الرسمية - غرفة رقم 5,مختلف,520,223,0,0,223
الشوف,جون ,المدرسة الرسمية - غرفة رقم 6,مسيحي,551,220,0,2,220
الشوف,جون ,المدرسة الرسمية - غرفة رقم 7,مسيحي,476,208,8,5,200
الشوف,حارة الناعمه ,ثانوية الرئيس الشهيد رفيق الحريري الرسمية - غرفة رقم 1,سني,578,331,0,1,331
الشوف,حارة الناعمه ,ثانوية الرئيس الشهيد رفيق الحريري الرسمية - غرفة رقم 2,سني,572,373,13,2,360
الشوف,حارة الناعمه ,ثانوية الرئيس الشهيد رفيق الحريري الرسمية - غرفة رقم 3,سني,604,327,5,1,322
الشوف,حارة الناعمه ,ثانوية الرئيس الشهيد رفيق الحريري الرسمية - غرفة رقم 4,سني,607,360,4,2,356
الشوف,حارة بعاصير ,صالة الكنيسة مار الياس - غرفة رقم 1,ماروني,364,242,7,0,235
الشوف,حارة جندل ,دار الاستقبال في البلدة - غرفة رقم 1,درزي,406,255,5,2,250
الشوف,حصروت ,المدرسة الرسمية - غرفة رقم 1,مختلف,571,313,3,5,310
الشوف,حصروت ,المدرسة الرسمية - غرفة رقم 2,مختلف,622,398,6,5,392
الشوف,خربة بسري ,كنيسة مار شربل - غرفة رقم 1,ماروني,71,36,0,0,36
الشوف,داريا ,المدرسة الرسمية - غرفة رقم 1,سني,594,378,15,8,363
الشوف,داريا ,المدرسة الرسمية - غرفة رقم 2,سني,610,360,8,13,352
الشوف,داريا ,المدرسة الرسمية - غرفة رقم 3,سني,550,368,15,2,353
الشوف,داريا ,المدرسة الرسمية - غرفة رقم 4,سني,578,356,5,2,351
الشوف,داريا ,المدرسة الرسمية - غرفة رقم 5,سني,598,331,7,1,324
الشوف,دلهون ,المدرسة الرسمية المختلطة - غرفة رقم 1,سني,505,321,11,13,310
الشوف,دلهون ,المدرسة الرسمية المختلطة - غرفة رقم 2,سني,511,336,11,12,325
الشوف,دلهون ,المدرسة الرسمية المختلطة - غرفة رقم 3,سني,520,348,2,16,346
الشوف,دميت ,المدرسة الرسمية - غرفة رقم 1,درزي,416,269,8,1,261
الشوف,دميت ,المدرسة الرسمية - غرفة رقم 2,درزي,422,257,7,2,250
الشوف,دميت ,المدرسة الرسمية - غرفة رقم 3,درزي,438,276,1,1,275
الشوف,دير القمر ,السراي القديمة - غرفة رقم 1,ماروني,557,146,2,0,144
الشوف,دير القمر ,السراي القديمة - غرفة رقم 2,روم كاثوليك,548,172,4,0,168
الشوف,دير القمر ,السراي القديمة - غرفة رقم 3,ماروني,526,239,1,1,238
الشوف,دير القمر ,السراي القديمة - غرفة رقم 4,ماروني,563,276,13,2,263
الشوف,دير القمر ,السراي القديمة - غرفة رقم 5,ماروني,545,240,1,2,239
الشوف,دير القمر ,السراي القديمة - غرفة رقم 6,ماروني,557,257,2,7,255
الشوف,دير القمر ,السراي القديمة - غرفة رقم 7,ماروني,544,279,1,1,278
الشوف,دير القمر ,السراي القديمة - غرفة رقم 8,ماروني,537,202,0,0,202
الشوف,دير القمر ,السراي القديمة - غرفة رقم 9,ماروني,547,217,1,1,216
الشوف,دير القمر ,المدرسة المهنية - غرفة رقم 1,ماروني,566,266,24,2,242
الشوف,دير القمر ,المدرسة المهنية - غرفة رقم 2,ماروني,557,260,0,0,260
الشوف,دير القمر ,المدرسة المهنية - غرفة رقم 3,ماروني,574,272,27,0,245
الشوف,دير القمر ,المدرسة المهنية - غرفة رقم 4,ماروني,556,289,1,2,288
الشوف,دير القمر ,المدرسة المهنية - غرفة رقم 5,ماروني,560,293,15,1,278
الشوف,دير القمر ,المدرسة المهنية - غرفة رقم 6,ماروني,549,209,17,1,192
الشوف,دير القمر ,المدرسة المهنية - غرفة رقم 7,مسيحي,498,116,0,1,116
الشوف,دير القمر ,المدرسة المهنية - غرفة رقم 8,روم كاثوليك,512,185,8,0,177
الشوف,دير القمر ,المدرسة المهنية - غرفة رقم 9,مختلف,537,95,4,0,91
الشوف,دير بابا ,المدرسة الرسمية - غرفة رقم 1,درزي,500,304,3,8,301
الشوف,دير بابا ,المدرسة الرسمية - غرفة رقم 2,درزي,470,284,3,5,281
الشوف,دير دوريت ,مركز البلدية - غرفة رقم 1,ماروني,449,238,2,2,236
الشوف,دير دوريت ,مركز البلدية - غرفة رقم 2,ماروني,463,227,0,0,227
الشوف,دير دوريت ,مركز البلدية - غرفة رقم 3,ماروني,471,247,0,0,247
الشوف,دير دوريت ,مركز البلدية - غرفة رقم 4,ماروني,454,206,3,0,203
الشوف,دير كوشه ,المدرسة الرسمية - غرفة رقم 1,درزي,542,316,2,2,314
الشوف,سبلين ,المدرسة الرسمية - غرفة رقم 1,مختلف,452,231,1,3,230
الشوف,سبلين ,المدرسة الرسمية - غرفة رقم 2,مختلف,517,278,6,3,272
الشوف,سرجبال ,مركز البلدية - غرفة رقم 1,مسيحي,600,335,2,2,333
الشوف,سرجبال ,مركز البلدية - غرفة رقم 2,مسيحي,580,317,2,0,315
الشوف,شحيم ,مجمع المدارس جبل سويد - غرفة رقم 1,سني,644,346,16,2,330
الشوف,شحيم ,مجمع المدارس جبل سويد - غرفة رقم 2,سني,609,312,4,4,308
الشوف,شحيم ,مجمع المدارس جبل سويد - غرفة رقم 3,سني,580,252,6,4,246
الشوف,شحيم ,مجمع المدارس جبل سويد - غرفة رقم 4,سني,658,387,10,1,377
الشوف,شحيم ,مجمع المدارس جبل سويد - غرفة رقم 5,سني,658,391,10,1,381
الشوف,شحيم ,مجمع المدارس جبل سويد - غرفة رقم 6,سني,671,339,17,3,322
الشوف,شحيم ,مجمع مدارس جبل سويد - غرفة رقم 7,سني,565,392,10,4,382
الشوف,شحيم ,مجمع مدارس جبل سويد - غرفة رقم 8,سني,548,319,9,1,310
الشوف,شحيم ,مجمع مدارس جبل سويد - غرفة رقم 9,سني,554,402,3,4,399
الشوف,شحيم ,مدرسة شحيم الرسمية الثانية – حي بلاط - غرفة رقم 1,سني,511,272,10,3,262
الشوف,شحيم ,مدرسة شحيم الرسمية الثانية – حي بلاط - غرفة رقم 2,سني,487,263,5,3,258
الشوف,شحيم ,مدرسة شحيم الرسمية الثانية – حي بلاط - غرفة رقم 3,سني,534,345,12,6,333
الشوف,شحيم ,مدرسة شحيم الرسمية الثانية – حي بلاط - غرفة رقم 4,سني,509,327,3,6,324
الشوف,شحيم ,مدرسة كوليج يونفرسال - غرفة رقم 1,سني,654,358,2,2,356
الشوف,شحيم ,مدرسة كوليج يونفرسال - غرفة رقم 2,سني,619,377,7,7,370
الشوف,شحيم ,مدرسة كوليج يونفرسال - غرفة رقم 3,سني,675,463,6,8,457
الشوف,شحيم ,مدرسة كوليج يونفرسال - غرفة رقم 4,سني,637,450,4,8,446
الشوف,شحيم ,معهد شحيم الفني - غرفة رقم 1,سني,504,259,7,2,252
الشوف,شحيم ,معهد شحيم الفني - غرفة رقم 10,سني,562,338,7,1,331
الشوف,شحيم ,معهد شحيم الفني - غرفة رقم 2,سني,466,322,12,3,310
الشوف,شحيم ,معهد شحيم الفني - غرفة رقم 3,سني,545,306,3,3,303
الشوف,شحيم ,معهد شحيم الفني - غرفة رقم 4,سني,554,327,6,5,321
الشوف,شحيم ,معهد شحيم الفني - غرفة رقم 5,سني,573,321,3,4,318
الشوف,شحيم ,معهد شحيم الفني - غرفة رقم 6,سني,533,300,5,2,295
الشوف,شحيم ,معهد شحيم الفني - غرفة رقم 7,سني,584,385,4,5,381
الشوف,شحيم ,معهد شحيم الفني - غرفة رقم 8,سني,589,395,18,5,377
الشوف,شحيم ,معهد شحيم الفني - غرفة رقم 9,سني,606,437,7,5,430
الشوف,شوريت ,مبنى كنيسة شوريت - غرفة رقم 1,ماروني,321,169,0,0,169
الشوف,ضهر المغارة ,مركز البلدية - غرفة رقم 1,ماروني,418,173,1,0,172
الشوف,عانوت ,المدرسة الرسمية - غرفة رقم 1,سني,516,288,3,8,285
الشوف,عانوت ,المدرسة الرسمية - غرفة رقم 2,سني,513,303,4,6,299
الشوف,عانوت ,المدرسة الرسمية - غرفة رقم 3,سني,511,328,5,5,323
الشوف,عانوت ,المدرسة الرسمية - غرفة رقم 4,سني,501,310,4,9,306
الشوف,عانوت ,المدرسة الرسمية - غرفة رقم 5,سني,510,296,4,4,292
الشوف,عترين ,المدرسة الرسمية - غرفة رقم 1,درزي,538,259,3,3,256
الشوف,عترين ,المدرسة الرسمية - غرفة رقم 2,درزي,588,268,1,1,267
الشوف,علمان ,صالون كنيسة مار يوحنا - غرفة رقم 1,ماروني,638,319,6,2,313
الشوف,علمان ,صالون كنيسة مار يوحنا - غرفة رقم 2,ماروني,665,295,0,2,295
الشوف,عماطور ,المدرسة الرسمية - غرفة رقم 1,درزي,515,274,1,6,273
الشوف,عماطور ,المدرسة الرسمية - غرفة رقم 2,درزي,521,238,3,2,235
الشوف,عماطور ,المدرسة الرسمية - غرفة رقم 3,درزي,536,304,6,5,298
الشوف,عماطور ,المدرسة الرسمية - غرفة رقم 4,درزي,533,268,0,2,268
الشوف,عماطور ,المدرسة الرسمية - غرفة رقم 5,مختلف,515,210,3,0,207
الشوف,عميق ,مركز البلدية - غرفة رقم 1,مسيحي,461,222,5,2,217
الشوف,عين الاسد والشميس ,صالة الكنيسة - غرفة رقم 1,ماروني,496,215,0,0,215
الشوف,عين الحور ,مركز البلدية - غرفة رقم 1,ماروني,395,229,4,0,225
الشوف,عين الحور ,مركز البلدية - غرفة رقم 2,ماروني,412,219,1,2,218
الشوف,عين زحلتا ,المدرسة الرسمية - غرفة رقم 1,درزي,550,258,1,4,257
الشوف,عين زحلتا ,المدرسة الرسمية - غرفة رقم 2,مختلف,534,235,5,1,230
الشوف,عين زحلتا ,المدرسة الرسمية - غرفة رقم 3,درزي,545,248,0,3,248
الشوف,عين زحلتا ,المدرسة الرسمية - غرفة رقم 4,مختلف,551,275,8,3,267
الشوف,عين زحلتا ,المدرسة الرسمية - غرفة رقم 5,مسيحي,499,236,3,0,233
الشوف,عين زحلتا ,المدرسة الرسمية - غرفة رقم 6,مسيحي,560,218,1,0,217
الشوف,عين قني ,دار الاستقبال في البلدة - غرفة رقم 1,درزي,440,240,8,0,232
الشوف,عين قني ,دار الاستقبال في البلدة - غرفة رقم 2,درزي,429,233,1,1,232
الشوف,عين قني ,دار الاستقبال في البلدة - غرفة رقم 3,درزي,411,223,1,2,222
الشوف,عين وزين ,المدرسة الرسمية - غرفة رقم 1,درزي,557,320,6,9,314
الشوف,عين وزين ,المدرسة الرسمية - غرفة رقم 2,درزي,582,337,4,3,333
الشوف,عينبال ,دار آل عبد الباقي - غرفة رقم 1,درزي,467,176,4,5,172
الشوف,عينبال ,دار آل عبد الباقي - غرفة رقم 2,مختلف,420,107,2,1,105
الشوف,عينبال ,دار آل عبد الباقي - غرفة رقم 3,درزي,482,164,5,0,159
الشوف,عينبال ,دار آل عبد الباقي - غرفة رقم 4,مختلف,474,140,1,0,139
الشوف,غريفه ,المدرسة الرسمية - غرفة رقم 1,درزي,577,308,5,3,303
الشوف,غريفه ,المدرسة الرسمية - غرفة رقم 2,درزي,560,238,7,3,231
الشوف,غريفه ,المدرسة الرسمية - غرفة رقم 3,درزي,561,277,2,2,275
الشوف,غريفه ,المدرسة الرسمية - غرفة رقم 4,درزي,564,283,0,0,283
الشوف,غريفه ,المدرسة الرسمية - غرفة رقم 5,درزي,549,243,5,1,238
الشوف,غريفه ,المدرسة الرسمية - غرفة رقم 6,درزي,556,269,2,2,267
الشوف,غريفه ,المدرسة الرسمية - غرفة رقم 7,مختلف,557,187,1,0,186
الشوف,كترمايا ,مجمع الرئيس الشهيد رفيق الحريري - غرفة رقم 1,سني,597,319,12,1,307
الشوف,كترمايا ,مجمع الرئيس الشهيد رفيق الحريري - غرفة رقم 10,مختلف,627,234,12,0,222
الشوف,كترمايا ,مجمع الرئيس الشهيد رفيق الحريري - غرفة رقم 2,مختلف,628,334,7,0,327
الشوف,كترمايا ,مجمع الرئيس الشهيد رفيق الحريري - غرفة رقم 3,سني,605,354,2,0,352
الشوف,كترمايا ,مجمع الرئيس الشهيد رفيق الحريري - غرفة رقم 4,سني,629,356,8,1,348
الشوف,كترمايا ,مجمع الرئيس الشهيد رفيق الحريري - غرفة رقم 5,مختلف,636,261,5,1,256
الشوف,كترمايا ,مجمع الرئيس الشهيد رفيق الحريري - غرفة رقم 6,سني,635,321,13,5,308
الشوف,كترمايا ,مجمع الرئيس الشهيد رفيق الحريري - غرفة رقم 7,سني,659,363,13,2,350
الشوف,كترمايا ,مجمع الرئيس الشهيد رفيق الحريري - غرفة رقم 8,سني,671,388,13,3,375
الشوف,كترمايا ,مجمع الرئيس الشهيد رفيق الحريري - غرفة رقم 9,سني,668,338,5,3,333
الشوف,كفر فاقود ,المدرسة الرسمية - غرفة رقم 1,درزي,537,332,10,4,322
الشوف,كفر فاقود ,المدرسة الرسمية - غرفة رقم 2,درزي,538,297,3,7,294
الشوف,كفر فاقود ,المدرسة الرسمية - غرفة رقم 3,درزي,583,338,2,5,336
الشوف,كفر فاقود ,المدرسة الرسمية - غرفة رقم 4,درزي,576,291,16,3,275
الشوف,كفر قطره ,المدرسة الرسمية - غرفة رقم 1,ماروني,553,251,6,3,245
الشوف,كفر قطره ,المدرسة الرسمية - غرفة رقم 2,مختلف,535,254,10,0,244
الشوف,كفر قطره ,المدرسة الرسمية - غرفة رقم 3,ماروني,578,260,4,2,256
الشوف,كفر قطره ,المدرسة الرسمية - غرفة رقم 4,مختلف,547,251,5,3,246
الشوف,كفرحي ,مبنى دارة البلدة - غرفة رقم 1,درزي,159,100,4,0,96
الشوف,كفرحيم ,ثانوية كفرحيم الرسمية - غرفة رقم 1,درزي,571,328,6,2,322
الشوف,كفرحيم ,ثانوية كفرحيم الرسمية - غرفة رقم 2,درزي,563,305,1,2,304
الشوف,كفرحيم ,ثانوية كفرحيم الرسمية - غرفة رقم 3,درزي,598,327,15,4,312
الشوف,كفرحيم ,ثانوية كفرحيم الرسمية - غرفة رقم 4,درزي,585,309,2,5,307
الشوف,كفرنبرخ ,المدرسة الرسمية - غرفة رقم 1,درزي,540,301,11,2,290
الشوف,كفرنبرخ ,المدرسة الرسمية - غرفة رقم 2,درزي,544,327,5,3,322
الشوف,كفرنبرخ ,المدرسة الرسمية - غرفة رقم 3,روم كاثوليك,516,258,1,3,257
الشوف,كفرنبرخ ,المدرسة الرسمية - غرفة رقم 4,مختلف,527,255,3,6,252
الشوف,كفرنبرخ ,مدرسة المحبة - غرفة رقم 1,درزي,546,290,4,3,286
الشوف,كفرنبرخ ,مدرسة المحبة - غرفة رقم 2,درزي,545,297,5,3,292
الشوف,كفرنبرخ ,مدرسة المحبة - غرفة رقم 3,روم كاثوليك,544,242,5,3,237
الشوف,كفرنبرخ ,مدرسة المحبة - غرفة رقم 4,مختلف,548,260,8,4,252
الشوف,كفرنيس ,صالون الكنيسة - غرفة رقم 1,ماروني,521,291,22,0,269
الشوف,كفرنيس ,صالون الكنيسة - غرفة رقم 2,ماروني,492,302,14,2,288
الشوف,كليليه ,مبنى البلدية الجديد في المشرف - غرفة رقم 2,ماروني,136,43,0,0,43
الشوف,مجدل المعوش ,المدرسة الرسمية - غرفة رقم 1,ماروني,484,243,9,1,234
الشوف,مجدل المعوش ,المدرسة الرسمية - غرفة رقم 2,ماروني,474,215,2,0,213
الشوف,مجدل المعوش ,المدرسة الرسمية - غرفة رقم 3,ماروني,492,213,1,0,212
الشوف,مجدل المعوش ,المدرسة الرسمية - غرفة رقم 4,ماروني,486,212,5,2,207
الشوف,مجدلونا ,صالة كنيسة مجدلونا - غرفة رقم 1,مسيحي,352,119,3,1,116
الشوف,مجدلونا ,صالة كنيسة مجدلونا - غرفة رقم 2,مسيحي,361,127,3,2,124
الشوف,مرج برجا ,صالة الكنيسة - غرفة رقم 1,ماروني,204,111,2,1,109
الشوف,مرستي ,المدرسة الرسمية - غرفة رقم 1,درزي,579,346,7,19,339
الشوف,مرستي ,المدرسة الرسمية - غرفة رقم 2,درزي,600,423,3,24,420
الشوف,مزبود ,المدرسة الرسمية - غرفة رقم 1,سني,547,257,4,3,253
الشوف,مزبود ,المدرسة الرسمية - غرفة رقم 2,سني,558,298,6,3,292
الشوف,مزبود ,المدرسة الرسمية - غرفة رقم 3,سني,557,284,5,6,279
الشوف,مزبود ,المدرسة الرسمية - غرفة رقم 4,سني,567,285,12,4,273
الشوف,مزبود ,المدرسة الرسمية - غرفة رقم 5,سني,512,270,2,1,268
الشوف,مزرعة الشوف ,المدرسة الرسمية - غرفة رقم 1,درزي,603,377,3,4,374
الشوف,مزرعة الشوف ,المدرسة الرسمية - غرفة رقم 2,درزي,606,335,1,4,334
الشوف,مزرعة الشوف ,المدرسة الرسمية - غرفة رقم 3,ماروني,596,202,2,1,200
الشوف,مزرعة الشوف ,المدرسة الرسمية - غرفة رقم 4,مختلف,568,230,2,7,228
الشوف,مزرعة الشوف ,المدرسة الرسمية - غرفة رقم 5,درزي,609,391,10,2,381
الشوف,مزرعة الشوف ,المدرسة الرسمية - غرفة رقم 6,درزي,598,358,6,8,352
الشوف,مزرعة الشوف ,المدرسة الرسمية - غرفة رقم 7,ماروني,602,188,16,1,172
الشوف,مزرعة الشوف ,المدرسة الرسمية - غرفة رقم 8,مختلف,627,303,2,2,301
الشوف,مزرعة الضهر ,مبنى البلدية - غرفة رقم 1,ماروني,456,196,0,1,196
الشوف,مزرعة الضهر ,مبنى البلدية - غرفة رقم 2,ماروني,467,187,7,2,180
الشوف,مزرعة الضهر ,مبنى البلدية - غرفة رقم 3,مسيحي,431,210,5,2,205
الشوف,مزموره ,صالة الكنيسة - غرفة رقم 1,ماروني,363,188,4,0,184
الشوف,معاصر الشوف ,دار البلدة - غرفة رقم 1,درزي,545,282,7,7,275
الشوف,معاصر الشوف ,دار البلدة - غرفة رقم 2,روم كاثوليك,534,199,1,3,198
الشوف,معاصر الشوف ,دار البلدة - غرفة رقم 3,مختلف,521,248,7,2,241
الشوف,معاصر الشوف ,دار البلدة - غرفة رقم 4,درزي,536,199,1,0,198
الشوف,معاصر الشوف ,دير مار ميخائيل - غرفة رقم 1,مختلف,494,195,8,1,187
الشوف,معاصر الشوف ,دير مار ميخائيل - غرفة رقم 2,روم كاثوليك,523,189,2,3,187
الشوف,معاصر بيت الدين ,صالون كنيسة مار الياس - غرفة رقم 1,مسيحي,440,222,0,2,222
الشوف,معاصر بيت الدين ,صالون كنيسة مار الياس - غرفة رقم 2,مسيحي,454,202,5,3,197
الشوف,نيحا ,ثانوية نيحا الرسمية - غرفة رقم 1,درزي,593,317,8,5,309
الشوف,نيحا ,ثانوية نيحا الرسمية - غرفة رقم 2,درزي,590,319,11,3,308
الشوف,نيحا ,ثانوية نيحا الرسمية - غرفة رقم 3,مختلف,566,264,6,2,258
الشوف,نيحا ,ثانوية نيحا الرسمية - غرفة رقم 4,درزي,586,327,2,1,325
الشوف,نيحا ,ثانوية نيحا الرسمية - غرفة رقم 5,درزي,586,349,6,6,343
الشوف,نيحا ,ثانوية نيحا الرسمية - غرفة رقم 6,مختلف,611,259,4,2,255
الشوف,وادي الدير ,بيت جاهز قرب منزل المختار السابق انطوان مارون - غرفة رقم 1,مسيحي,278,156,1,0,155
الشوف,وادي الست ,مدرسة وقف مار متى - غرفة رقم 1,ماروني,492,291,0,0,291
الشوف,وادي الست ,مدرسة وقف مار متى - غرفة رقم 2,ماروني,544,328,0,2,328
الشوف,وادي بنحليه ,الكنيسة - غرفة رقم 1,مسيحي,426,251,10,3,241
الشوف,وادي بنحليه ,الكنيسة - غرفة رقم 2,مسيحي,456,225,4,0,221
الشوف,وادي دير دوريت ,بيت جاهز قرب منزل المختار انيس راشد - غرفة رقم 1,مسيحي,211,115,5,1,110
الضنية,الحازمية ,المدرسة الرسمية - غرفة رقم 1,سني,342,191,2,1,189
الضنية,الخرنوب ,المدرسة الرسمية - غرفة رقم 1,روم ارثوذكس,297,107,2,2,105
الضنية,الروضة ,المدرسة الرسمية - غرفة رقم 1,مسلم,632,335,10,2,325
الضنية,السفيرة ,المدرسة الرسمية - غرفة رقم 1,سني,655,385,12,6,373
الضنية,السفيرة ,المدرسة الرسمية - غرفة رقم 2,سني,646,383,2,1,381
الضنية,السفيرة ,المدرسة الرسمية - غرفة رقم 3,سني,658,387,4,0,383
الضنية,السفيرة ,المدرسة الرسمية - غرفة رقم 4,سني,676,382,15,4,367
الضنية,السفيرة ,ثانوية السفيره - غرفة رقم 1,سني,642,355,7,3,348
الضنية,السفيرة ,ثانوية السفيره - غرفة رقم 2,سني,612,359,7,3,352
الضنية,السفيرة ,ثانوية السفيره - غرفة رقم 3,سني,615,331,10,3,321
الضنية,السفيرة ,ثانوية السفيره - غرفة رقم 4,سني,669,405,4,4,401
الضنية,السفيرة ,ثانوية السفيره - غرفة رقم 5,سني,622,373,7,1,366
الضنية,الضنية موظفون ,سراي دير عمار - غرفة رقم 1,مختلف,572,530,4,16,526
الضنية,القطين ,المدرسة الرسمية - غرفة رقم 1,سني,517,304,13,5,291
الضنية,القطين ,المدرسة الرسمية - غرفة رقم 2,سني,310,310,7,1,303
الضنية,القطين ,المدرسة الرسمية - غرفة رقم 3,مختلف,483,153,3,3,150
الضنية,القمامين ,المدرسة الرسمية - غرفة رقم 1,سني,612,310,10,1,300
الضنية,المطل ,المدرسة الرسمية - غرفة رقم 1,سني,503,358,3,0,355
الضنية,ايزال ,المدرسة الرسمية - غرفة رقم 1,سني,580,375,10,3,365
الضنية,ايزال ,المدرسة الرسمية - غرفة رقم 2,سني,568,368,22,2,346
الضنية,ايزال ,المدرسة الرسمية - غرفة رقم 3,سني,559,344,5,7,339
الضنية,ايزال ,المدرسة الرسمية - غرفة رقم 4,سني,601,369,19,6,350
الضنية,بحويتا ,قاعة الكنيسة - غرفة رقم 1,ماروني,478,153,2,1,151
الضنية,بخعون ,المدرسة الرسمية للصبيان - غرفة رقم 1,سني,639,354,1,4,353
الضنية,بخعون ,المدرسة الرسمية للصبيان - غرفة رقم 2,سني,665,327,4,3,323
الضنية,بخعون ,المدرسة الرسمية للصبيان - غرفة رقم 3,سني,675,393,8,3,385
الضنية,بخعون ,المدرسة الرسمية للصبيان - غرفة رقم 4,سني,678,376,3,2,373
الضنية,بخعون ,المدرسة الرسمية للصبيان - غرفة رقم 5,سني,671,417,3,1,414
الضنية,بخعون ,المدرسة الرسمية للصبيان - غرفة رقم 6,سني,647,370,12,0,358
الضنية,بخعون ,مدرسة بخعون الفنية الرسمية - غرفة رقم 1,سني,667,367,9,1,358
الضنية,بخعون ,مدرسة بخعون الفنية الرسمية - غرفة رقم 2,سني,643,346,5,5,341
الضنية,بخعون ,مدرسة بخعون الفنية الرسمية - غرفة رقم 3,سني,684,415,15,2,400
الضنية,بخعون ,مدرسة بخعون الفنية الرسمية - غرفة رقم 4,سني,664,361,7,4,354
الضنية,بخعون ,مدرسة بخعون الفنية الرسمية - غرفة رقم 5,سني,657,380,9,0,371
الضنية,بخعون ,مدرسة بخعون الفنية الرسمية - غرفة رقم 6,سني,649,378,8,1,370
الضنية,بطرماز ,المدرسة الرسمية - غرفة رقم 1,سني,583,359,12,1,347
الضنية,بطرماز ,المدرسة الرسمية - غرفة رقم 2,سني,550,315,22,2,293
الضنية,بطرماز ,المدرسة الرسمية - غرفة رقم 3,سني,597,352,6,5,346
الضنية,بطرماز ,المدرسة الرسمية - غرفة رقم 4,سني,577,336,4,8,332
الضنية,بقاع صفرين ,المدرسة الرسمية - غرفة رقم 1,سني,610,248,3,5,245
الضنية,بقاع صفرين ,المدرسة الرسمية - غرفة رقم 2,سني,627,311,23,12,288
الضنية,بقاع صفرين ,المدرسة الرسمية - غرفة رقم 3,سني,648,403,19,6,384
الضنية,بقاع صفرين ,المدرسة الرسمية - غرفة رقم 4,سني,592,228,4,6,224
الضنية,بقاع صفرين ,المدرسة الرسمية - غرفة رقم 5,سني,590,260,1,7,259
الضنية,بقاع صفرين ,المدرسة الرسمية - غرفة رقم 6,سني,591,364,6,3,358
الضنية,بقرصونه ,المدرسة الرسمية الشرقية - غرفة رقم 1,سني,591,334,5,3,329
الضنية,بقرصونه ,المدرسة الرسمية الشرقية - غرفة رقم 2,سني,650,347,18,2,329
الضنية,بقرصونه ,المدرسة الرسمية الشرقية - غرفة رقم 3,سني,615,313,8,3,305
الضنية,بقرصونه ,المدرسة الرسمية الشرقية - غرفة رقم 4,سني,615,303,15,2,288
الضنية,بقرصونه ,المدرسة الرسمية الشرقية - غرفة رقم 5,سني,615,407,2,2,405
الضنية,بيت الفقس ,المدرسة التكميلية المختلطة الرسمية - غرفة رقم 1,سني,675,402,4,0,398
الضنية,بيت الفقس ,المدرسة التكميلية المختلطة الرسمية - غرفة رقم 2,سني,711,408,7,5,401
الضنية,بيت الفقس ,المدرسة التكميلية المختلطة الرسمية - غرفة رقم 3,سني,653,399,5,3,394
الضنية,بيت حاويك ,المدرسة الرسمية - غرفة رقم 1,سني,733,396,3,2,393
الضنية,حرف السياد ,المدرسة الرسمية - غرفة رقم 1,سني,551,357,8,2,349
الضنية,حقل العزيمه ,المدرسة التكميلية الرسمية - غرفة رقم 1,روم ارثوذكس,504,191,4,2,187
الضنية,حقل العزيمه ,المدرسة التكميلية الرسمية - غرفة رقم 2,روم ارثوذكس,512,193,7,0,186
الضنية,حقل العزيمه ,المدرسة التكميلية الرسمية - غرفة رقم 3,روم ارثوذكس,481,166,8,4,158
الضنية,حوارة ,قاعة كنيسة مار الياس في البلده - غرفة رقم 1,ماروني,647,285,1,2,284
الضنية,دبعل ,المدرسة الرسمية الجديدة - غرفة رقم 1,سني,556,284,3,4,281
الضنية,دبعل ,المدرسة الرسمية الجديدة - غرفة رقم 2,سني,556,314,18,1,296
الضنية,دول إقليمية,دول إقليمية,مختلف,938,513,18,3,495
الضنية,دير نبوح ,المدرسة الرسمية - غرفة رقم 1,مختلف,514,290,11,3,279
الضنية,دير نبوح ,المدرسة الرسمية - غرفة رقم 2,مختلف,505,294,1,6,293
الضنية,زغرتغرين ,قاعة الكنيسة - غرفة رقم 1,ماروني,386,124,2,0,122
الضنية,زغرتغرين ,قاعة الكنيسة - غرفة رقم 2,ماروني,352,115,3,0,112
الضنية,سير ,المدرسة الرسمية للبنات - غرفة رقم 1,سني,645,338,13,1,325
الضنية,سير ,المدرسة الرسمية للبنات - غرفة رقم 2,سني,634,307,12,3,295
الضنية,سير ,المدرسة الرسمية للبنات - غرفة رقم 3,سني,650,288,21,4,267
الضنية,سير ,المدرسة الرسمية للبنات - غرفة رقم 4,سني,649,325,23,3,302
الضنية,سير ,المدرسة الرسمية للبنات - غرفة رقم 5,ماروني,569,128,2,0,126
الضنية,سير ,المدرسة الرسمية للصبيان - غرفة رقم 1,سني,656,330,6,3,324
الضنية,سير ,المدرسة الرسمية للصبيان - غرفة رقم 2,سني,641,305,11,5,294
الضنية,سير ,المدرسة الرسمية للصبيان - غرفة رقم 3,سني,637,272,7,4,265
الضنية,سير ,المدرسة الرسمية للصبيان - غرفة رقم 4,سني,650,337,6,5,331
الضنية,سير ,المدرسة الرسمية للصبيان - غرفة رقم 5,ماروني,585,125,1,2,124
الضنية,طاران ,المدرسة الرسمية - غرفة رقم 1,سني,696,433,20,3,413
الضنية,طاران ,المدرسة الرسمية - غرفة رقم 2,سني,683,427,30,5,397
الضنية,طاران ,المدرسة الرسمية - غرفة رقم 3,سني,697,425,6,6,419
الضنية,عاصون ,المدرسة الرسمية الاولى - غرفة رقم 1,سني,676,371,4,5,367
الضنية,عاصون ,المدرسة الرسمية الاولى - غرفة رقم 2,مختلف,677,156,2,0,154
الضنية,عاصون ,المدرسة الرسمية الاولى - غرفة رقم 3,سني,700,393,12,8,381
الضنية,عاصون ,المدرسة الرسمية الاولى - غرفة رقم 4,مختلف,647,121,1,1,120
الضنية,عزقي ,المدرسة الرسمية - غرفة رقم 1,سني,670,342,5,6,337
الضنية,عزقي ,المدرسة الرسمية - غرفة رقم 2,سني,635,329,4,10,325
الضنية,عزقي ,المدرسة الرسمية - غرفة رقم 3,مختلف,638,386,23,7,363
الضنية,عيمار ,المدرسة الرسمية المختلطة - غرفة رقم 1,ماروني,555,138,0,4,138
الضنية,عيمار ,المدرسة الرسمية المختلطة - غرفة رقم 2,ماروني,508,144,1,3,143
الضنية,عين التينة ,المدرسة الرسمية - غرفة رقم 1,سني,377,238,4,0,234
الضنية,عين التينة ,المدرسة الرسمية - غرفة رقم 2,سني,387,255,1,1,254
الضنية,قرصيتا ,المدرسة الرسمية - غرفة رقم 1,سني,657,301,5,5,296
الضنية,قرصيتا ,المدرسة الرسمية - غرفة رقم 2,سني,621,301,3,2,298
الضنية,قرصيتا ,المدرسة الرسمية - غرفة رقم 3,سني,614,285,12,2,273
الضنية,قرصيتا ,المدرسة الرسمية - غرفة رقم 4,سني,632,322,17,5,305
الضنية,قرصيتا ,المدرسة الرسمية - غرفة رقم 5,سني,651,322,2,0,320
الضنية,قزحيا ,المدرسة الرسمية - غرفة رقم 1,سني,549,322,6,1,316
الضنية,قزحيا ,المدرسة الرسمية - غرفة رقم 2,سني,559,334,20,1,314
الضنية,كرم المهر ,المدرسة الرسمية - غرفة رقم 1,ماروني,562,92,2,0,90
الضنية,كرم المهر ,المدرسة الرسمية - غرفة رقم 2,ماروني,599,113,4,2,109
الضنية,كرم المهر ,المدرسة الرسمية - غرفة رقم 3,ماروني,625,84,7,1,77
الضنية,كفر حبو ,المدرسة الرسمية الجديدة - غرفة رقم 1,روم ارثوذكس,574,179,2,1,177
الضنية,كفر حبو ,المدرسة الرسمية الجديدة - غرفة رقم 2,روم ارثوذكس,530,120,1,1,119
الضنية,كفر حبو ,المدرسة الرسمية الجديدة - غرفة رقم 3,روم ارثوذكس,570,176,5,3,171
الضنية,كفر حبو ,المدرسة الرسمية الجديدة - غرفة رقم 4,روم ارثوذكس,546,131,1,1,130
الضنية,كفر حبو ,المدرسة الرسمية الجديدة - غرفة رقم 5,مختلف,566,295,19,7,276
الضنية,كفر شلان ,مبنى البلدية - غرفة رقم 1,سني,678,305,22,2,283
الضنية,كفربنين ,المدرسة الرسمية - غرفة رقم 1,سني,576,355,18,1,337
الضنية,كفربنين ,المدرسة الرسمية - غرفة رقم 2,سني,599,393,18,7,375
الضنية,كهف الملول ,المدرسة الرسمية - غرفة رقم 1,ماروني,616,149,1,6,148
الضنية,مراح السريج ,المدرسة الرسمية - غرفة رقم 1,سني,576,241,9,7,232
الضنية,مراح السريج ,المدرسة الرسمية - غرفة رقم 2,سني,576,254,11,1,243
الضنية,مراح السفيرة ,المدرسة الرسمية - غرفة رقم 1,مختلف,436,187,4,5,183
الضنية,مراح السفيرة ,المدرسة الرسمية - غرفة رقم 2,مختلف,445,206,4,10,202
الضنية,مزرعة القرين , المدرسة الرسمية ,روم ارثوذكس,180,78,0,0,78
الضنية,نمرين , المدرسة الرسمية  ,سني,693,422,23,3,399
الكورة,اجد عبرين ,مبنى البلدية - غرفة رقم 1,مختلف,447,238,2,2,236
الكورة,اجد عبرين ,مبنى البلدية - غرفة رقم 2,مختلف,475,288,12,5,276
الكورة,البحصاص ,الخلية الاجتماعية في بلدة راسمسقا الشمالي - غرفة رقم 2,ماروني,1675,49,1,0,48
الكورة,الكورة موظفون ,سراي اميون - غرفة رقم 1,مختلف,222,208,4,5,204
الكورة,المجدل ,قاعة كنيسة مريم المجدلية - غرفة رقم 1,ماروني,330,183,1,2,182
الكورة,المجدل ,قاعة كنيسة مريم المجدلية - غرفة رقم 2,ماروني,317,205,2,2,203
الكورة,النخله ,خلية مسجد صلاح الدين - غرفة رقم 1,مختلف,410,196,2,1,194
الكورة,النخله ,خلية مسجد صلاح الدين - غرفة رقم 2,مختلف,426,235,2,5,233
الكورة,اميون شرقي ,ثانوية اميون الرسمية - غرفة رقم 1,روم ارثوذكس,486,206,4,1,202
الكورة,اميون شرقي ,ثانوية اميون الرسمية - غرفة رقم 2,روم ارثوذكس,480,181,6,0,175
الكورة,اميون شرقي ,ثانوية اميون الرسمية - غرفة رقم 3,روم ارثوذكس,517,168,4,2,164
الكورة,اميون شرقي ,ثانوية اميون الرسمية - غرفة رقم 4,روم ارثوذكس,528,254,1,3,253
الكورة,اميون شرقي ,ثانوية اميون الرسمية - غرفة رقم 5,روم ارثوذكس,487,203,2,1,201
الكورة,اميون شرقي ,ثانوية اميون الرسمية - غرفة رقم 6,روم ارثوذكس,485,166,3,4,163
الكورة,اميون شرقي ,ثانوية اميون الرسمية - غرفة رقم 7,روم ارثوذكس,523,80,1,3,79
الكورة,اميون غربي ,المدرسة الرسمية للصبيان - غرفة رقم 1,روم ارثوذكس,563,191,0,0,191
الكورة,اميون غربي ,المدرسة الرسمية للصبيان - غرفة رقم 2,روم ارثوذكس,559,217,0,1,217
الكورة,اميون غربي ,المدرسة الرسمية للصبيان - غرفة رقم 3,روم ارثوذكس,545,152,0,1,152
الكورة,اميون غربي ,المدرسة الرسمية للصبيان - غرفة رقم 4,روم ارثوذكس,557,220,2,3,218
الكورة,اميون غربي ,المدرسة الرسمية للصبيان - غرفة رقم 5,روم ارثوذكس,555,211,0,0,211
الكورة,اميون غربي ,المدرسة الرسمية للصبيان - غرفة رقم 6,روم ارثوذكس,583,205,1,5,204
الكورة,انفه ,المدرسة الرسمية للصبيان - غرفة رقم 1,روم ارثوذكس,537,306,4,1,302
الكورة,انفه ,المدرسة الرسمية للصبيان - غرفة رقم 2,روم ارثوذكس,524,224,4,3,220
الكورة,انفه ,المدرسة الرسمية للصبيان - غرفة رقم 3,روم ارثوذكس,533,274,8,4,266
الكورة,انفه ,المدرسة الرسمية للصبيان - غرفة رقم 4,روم ارثوذكس,560,234,4,1,230
الكورة,انفه ,المدرسة الرسمية للصبيان - غرفة رقم 5,روم ارثوذكس,528,325,7,4,318
الكورة,انفه ,المدرسة الرسمية للصبيان - غرفة رقم 6,روم ارثوذكس,535,257,8,3,249
الكورة,انفه ,المدرسة الرسمية للصبيان - غرفة رقم 7,روم ارثوذكس,535,307,9,3,298
الكورة,انفه ,المدرسة الرسمية للصبيان - غرفة رقم 8,روم ارثوذكس,567,244,14,2,230
الكورة,انفه ,المدرسة الرسمية للصبيان - غرفة رقم 9,سني,648,427,31,15,396
الكورة,بترومين ,مبنى بلدية بترومين - غرفة رقم 1,روم ارثوذكس,435,144,3,1,141
الكورة,بترومين ,مبنى بلدية بترومين - غرفة رقم 2,روم ارثوذكس,416,139,1,2,138
الكورة,بترومين ,مبنى بلدية بترومين - غرفة رقم 3,روم ارثوذكس,383,126,2,4,124
الكورة,بتعبوره ,دار البلدية - غرفة رقم 1,روم ارثوذكس,345,104,4,0,100
الكورة,بتعبوره ,دار البلدية - غرفة رقم 2,روم ارثوذكس,342,120,14,1,106
الكورة,بتوراتيج ,المدرسة الرسمية - غرفة رقم 1,سني,422,182,6,4,176
الكورة,بتوراتيج ,المدرسة الرسمية - غرفة رقم 2,سني,479,219,5,3,214
الكورة,بحبوش ,مبنى مهنية جمعية انعاش القرى الخمس - غرفة رقم 1,مختلف,315,109,5,0,104
الكورة,بحبوش ,مبنى مهنية جمعية انعاش القرى الخمس - غرفة رقم 2,مختلف,337,142,1,1,141
الكورة,بدبا ,مبنى البلدية - غرفة رقم 1,مسيحي,476,149,8,0,141
الكورة,بدبا ,مبنى البلدية - غرفة رقم 2,مسيحي,470,199,6,2,193
الكورة,بدبهون ,مدرسة برغون الرسمية - غرفة رقم 2,سني,174,82,0,2,82
الكورة,بدنايل ,المدرسة الرسمية السابقة - غرفة رقم 1,سني,452,294,1,1,293
الكورة,برسا ,المدرسة الرسمية - غرفة رقم 1,ماروني,433,139,0,0,139
الكورة,برسا ,المدرسة الرسمية - غرفة رقم 2,ماروني,446,166,1,1,165
الكورة,برسا ,المدرسة الرسمية - غرفة رقم 3,روم ارثوذكس,411,176,2,0,174
الكورة,برغون ,مدرسة برغون الرسمية - غرفة رقم 1,سني,370,203,4,3,199
الكورة,بزيزا ,المدرسة الرسمية - غرفة رقم 1,مسيحي,520,242,19,2,223
الكورة,بزيزا ,المدرسة الرسمية - غرفة رقم 2,مسيحي,587,278,11,3,267
الكورة,بشمزين ,مدرسة بشمزين العالية - غرفة رقم 1,روم ارثوذكس,542,162,1,2,161
الكورة,بشمزين ,مدرسة بشمزين العالية - غرفة رقم 2,روم ارثوذكس,457,168,4,1,164
الكورة,بشمزين ,مدرسة بشمزين العالية - غرفة رقم 3,روم ارثوذكس,557,200,5,0,195
الكورة,بشمزين ,مدرسة بشمزين العالية - غرفة رقم 4,روم ارثوذكس,502,188,1,0,187
الكورة,بصرما ,دار البلدية - غرفة رقم 1,ماروني,550,142,3,1,139
الكورة,بصرما ,دار البلدية - غرفة رقم 2,روم ارثوذكس,367,190,1,0,189
الكورة,بصرما ,دار البلدية - غرفة رقم 3,روم ارثوذكس,411,146,0,0,146
الكورة,بطرام ,المدرسة الرسمية - غرفة رقم 1,روم ارثوذكس,546,174,5,1,169
الكورة,بطرام ,المدرسة الرسمية - غرفة رقم 2,روم ارثوذكس,419,74,1,1,73
الكورة,بطرام ,المدرسة الرسمية - غرفة رقم 3,روم ارثوذكس,578,209,3,4,206
الكورة,بطرام ,المدرسة الرسمية - غرفة رقم 4,روم ارثوذكس,407,78,1,2,77
الكورة,بكفتين ,مبنى البلدية - غرفة رقم 1,مختلف,419,156,9,3,147
الكورة,بنهران ,الجمعية الخيرية - غرفة رقم 1,شيعي,418,207,3,1,204
الكورة,حارة الخاصة ,خلية مسجد صلاح الدين - غرفة رقم 3,ماروني,363,104,1,0,103
الكورة,دار بعشتار ,المدرسة الرسمية - غرفة رقم 1,ماروني,501,207,8,1,199
الكورة,دار بعشتار ,المدرسة الرسمية - غرفة رقم 2,ماروني,472,172,9,1,163
الكورة,دار بعشتار ,المدرسة الرسمية - غرفة رقم 3,ماروني,478,203,4,0,199
الكورة,دار بعشتار ,المدرسة الرسمية - غرفة رقم 4,ماروني,435,189,1,2,188
الكورة,دار بعشتار ,المدرسة الرسمية - غرفة رقم 5,ماروني,519,131,3,0,128
الكورة,دار شمزين ,قاعة الكنيسة - غرفة رقم 1,مسيحي,418,162,8,1,154
الكورة,دده ,المدرسة الرسمية - غرفة رقم 1,روم ارثوذكس,604,251,4,2,247
الكورة,دده ,المدرسة الرسمية - غرفة رقم 2,روم ارثوذكس,587,268,7,0,261
الكورة,دده ,المدرسة الرسمية - غرفة رقم 3,روم ارثوذكس,597,301,3,0,298
الكورة,دده ,المدرسة الرسمية - غرفة رقم 4,روم ارثوذكس,617,320,6,4,314
الكورة,دده ,المدرسة الرسمية - غرفة رقم 5,سني,615,367,10,2,357
الكورة,دده ,المدرسة الرسمية - غرفة رقم 6,سني,627,435,19,11,416
الكورة,دده ,المدرسة الرسمية - غرفة رقم 7,سني,625,328,11,9,317
الكورة,دول إقليمية,دول إقليمية,مختلف,2381,1513,23,11,1490
الكورة,راس مسقا الجنوبية ,المدرسة الرسمية - غرفة رقم 1,مسيحي,402,117,2,1,115
الكورة,راس مسقا الجنوبية ,المدرسة الرسمية - غرفة رقم 2,مسيحي,388,135,1,1,134
الكورة,راس مسقا الشمالية ,الخلية الاجتماعية - غرفة رقم 1,سني,360,209,1,2,208
الكورة,رشدبين ,المدرسة الرسمية - غرفة رقم 1,ماروني,450,220,1,9,219
الكورة,رشدبين ,المدرسة الرسمية - غرفة رقم 2,ماروني,429,251,5,3,246
الكورة,زغرتا المتاولة ,حسينية جمعية المبرات الخيرية - غرفة رقم 1,شيعي,193,117,3,0,114
الكورة,زكرون ,صالون الكنيسة - غرفة رقم 1,ماروني,276,176,1,1,175
الكورة,ضهر العين ,المدرسة الرسمية - غرفة رقم 1,مسيحي,195,89,4,1,85
الكورة,ضهور الهوا ,قاعة الشهيد باسل الاسد - غرفة رقم 1,مسلم,361,258,1,0,257
الكورة,عابا ,قاعة كنيسة مار الياس - غرفة رقم 1,روم ارثوذكس,402,111,2,0,109
الكورة,عابا ,قاعة كنيسة مار الياس - غرفة رقم 2,روم ارثوذكس,414,151,1,0,150
الكورة,عفصديق ,مركز البلدية الجديد - غرفة رقم 1,مختلف,471,194,0,1,194
الكورة,عفصديق ,مركز البلدية الجديد - غرفة رقم 2,مختلف,474,219,3,0,216
الكورة,عين عكرين ,المدرسة المختلطة الرسمية - غرفة رقم 1,ماروني,592,304,1,2,303
الكورة,عين عكرين ,المدرسة المختلطة الرسمية - غرفة رقم 2,ماروني,625,346,6,5,340
الكورة,فيع ,المدرسة الرسمية - غرفة رقم 1,روم ارثوذكس,531,244,9,0,235
الكورة,فيع ,المدرسة الرسمية - غرفة رقم 2,روم ارثوذكس,512,286,6,6,280
الكورة,فيع ,المدرسة الرسمية - غرفة رقم 3,روم ارثوذكس,505,199,0,3,199
الكورة,قلحات ,النادي الثقافي الرياضي - غرفة رقم 1,روم ارثوذكس,567,217,3,2,214
الكورة,قلحات ,النادي الثقافي الرياضي - غرفة رقم 2,روم ارثوذكس,560,238,7,4,231
الكورة,كفتون ,قاعة البلدية - غرفة رقم 1,روم ارثوذكس,478,176,0,0,176
الكورة,كفر حزير ,المدرسة الرسمية - غرفة رقم 1,روم ارثوذكس,519,222,10,1,212
الكورة,كفر حزير ,المدرسة الرسمية - غرفة رقم 2,روم ارثوذكس,530,195,5,0,190
الكورة,كفر حزير ,المدرسة الرسمية - غرفة رقم 3,روم ارثوذكس,517,246,8,0,238
الكورة,كفر حزير ,المدرسة الرسمية - غرفة رقم 4,روم ارثوذكس,521,230,4,2,226
الكورة,كفر حزير ,المدرسة الرسمية - غرفة رقم 5,روم ارثوذكس,464,105,1,0,104
الكورة,كفر صارون ,المدرسة الرسمية سابقا(النادي حاليا) - غرفة رقم 1,مسيحي,395,150,0,0,150
الكورة,كفر صارون ,المدرسة الرسمية سابقا(النادي حاليا) - غرفة رقم 2,مسيحي,407,181,2,1,179
الكورة,كفر قاهل ,مركز البلدية - غرفة رقم 1,مختلف,402,120,1,4,119
الكورة,كفر قاهل ,مركز البلدية - غرفة رقم 2,مختلف,415,127,1,0,126
الكورة,كفرحاتا ,المدرسة الرسمية - غرفة رقم 1,روم ارثوذكس,504,232,1,0,231
الكورة,كفرحاتا ,المدرسة الرسمية - غرفة رقم 2,روم ارثوذكس,551,277,7,3,270
الكورة,كفرعقا ,المدرسة الرسمية للصبيان - غرفة رقم 1,روم ارثوذكس,522,273,2,4,271
الكورة,كفرعقا ,المدرسة الرسمية للصبيان - غرفة رقم 2,روم ارثوذكس,530,255,2,2,253
الكورة,كفرعقا ,المدرسة الرسمية للصبيان - غرفة رقم 3,روم ارثوذكس,518,218,0,2,218
الكورة,كفرعقا ,المدرسة الرسمية للصبيان - غرفة رقم 4,روم ارثوذكس,537,290,10,7,280
الكورة,كفرعقا ,المدرسة الرسمية للصبيان - غرفة رقم 5,روم ارثوذكس,509,255,12,4,243
الكورة,كفرعقا ,المدرسة الرسمية للصبيان - غرفة رقم 6,روم ارثوذكس,515,274,6,6,268
الكورة,كفرعقا ,المدرسة الرسمية للصبيان - غرفة رقم 7,روم ارثوذكس,451,98,0,2,98
الكورة,كفريا ,المدرسة الرسمية - غرفة رقم 1,سني,427,232,6,9,226
الكورة,كفريا ,المدرسة الرسمية - غرفة رقم 2,سني,478,287,3,13,284
الكورة,كفريا ,المدرسة الرسمية - غرفة رقم 3,مختلف,510,291,11,13,280
الكورة,كوسبا ,المدرسة الرسمية للبنات - غرفة رقم 1,روم ارثوذكس,506,227,4,1,223
الكورة,كوسبا ,المدرسة الرسمية للبنات - غرفة رقم 2,روم ارثوذكس,514,222,2,3,220
الكورة,كوسبا ,المدرسة الرسمية للبنات - غرفة رقم 3,روم ارثوذكس,506,270,7,2,263
الكورة,كوسبا ,المدرسة الرسمية للبنات - غرفة رقم 4,مسيحي,632,297,5,3,292
الكورة,كوسبا ,المدرسة الرسمية للصبيان - غرفة رقم 1,روم ارثوذكس,506,151,0,0,151
الكورة,كوسبا ,المدرسة الرسمية للصبيان - غرفة رقم 2,روم ارثوذكس,507,187,0,0,187
الكورة,كوسبا ,المدرسة الرسمية للصبيان - غرفة رقم 3,روم ارثوذكس,5126,194,2,7,192
الكورة,كوسبا ,المدرسة الرسمية للصبيان - غرفة رقم 4,روم ارثوذكس,480,152,1,1,151
الكورة,كوسبا ,المدرسة الرسمية للصبيان - غرفة رقم 5,روم ارثوذكس,521,183,2,0,181
الكورة,متريت ,دار البلدية - غرفة رقم 1,ماروني,420,74,0,0,74
الكورة,متريت ,دار البلدية - غرفة رقم 2,ماروني,374,74,0,0,74
المتن,ابو ميزان ,وقف كنيسة القديس مار جورجيوس - غرفة رقم 1,روم ارثوذكس,22,14,0,0,14
المتن,البوشريه ,مدرسة الاخطل الصغير - غرفة رقم 1,روم ارثوذكس,544,317,12,1,305
المتن,البوشريه ,مدرسة الاخطل الصغير - غرفة رقم 2,مسيحي,543,232,9,2,223
المتن,البوشريه ,مدرسة الاخطل الصغير - غرفة رقم 3,مسيحي,576,270,2,2,268
المتن,البوشريه ,مدرسة الاخطل الصغير - غرفة رقم 4,مختلف,571,213,13,1,200
المتن,البوشريه ,مدرسة الاخطل الصغير - غرفة رقم 5,روم ارثوذكس,574,312,7,3,305
المتن,البوشريه ,مدرسة الاخطل الصغير - غرفة رقم 6,مسيحي,565,235,2,1,233
المتن,البوشريه ,مدرسة الاخطل الصغير - غرفة رقم 7,مسيحي,583,269,2,4,267
المتن,البوشريه ,مدرسة الاخطل الصغير - غرفة رقم 8,مختلف,539,206,13,1,193
المتن,البوشريه ,مدرسة مار مارون البوشرية - غرفة رقم 1,ماروني,545,322,4,0,318
المتن,البوشريه ,مدرسة مار مارون البوشرية - غرفة رقم 2,ماروني,546,296,3,1,293
المتن,البوشريه ,مدرسة مار مارون البوشرية - غرفة رقم 3,مختلف,558,287,1,2,286
المتن,البوشريه ,مدرسة مار مارون البوشرية - غرفة رقم 4,ماروني,572,338,5,0,333
المتن,البوشريه ,مدرسة مار مارون البوشرية - غرفة رقم 5,ماروني,583,324,7,3,317
المتن,البوشريه ,مدرسة مار مارون البوشرية - غرفة رقم 6,مختلف,605,291,1,3,290
المتن,الجديدة ,الثانوية الرسمية للبنات - غرفة رقم 1,ماروني,531,323,4,3,319
المتن,الجديدة ,الثانوية الرسمية للبنات - غرفة رقم 2,ماروني,534,294,10,1,284
المتن,الجديدة ,الثانوية الرسمية للبنات - غرفة رقم 3,مسيحي,538,204,8,1,196
المتن,الجديدة ,الثانوية الرسمية للبنات - غرفة رقم 4,مسلم,574,367,31,5,336
المتن,الجديدة ,الثانوية الرسمية للبنات - غرفة رقم 5,ماروني,580,332,5,1,327
المتن,الجديدة ,الثانوية الرسمية للبنات - غرفة رقم 6,ماروني,583,337,5,0,332
المتن,الجديدة ,الثانوية الرسمية للبنات - غرفة رقم 7,مسيحي,576,226,4,2,222
المتن,الجديدة ,الثانوية الرسمية للبنات - غرفة رقم 8,مسلم,615,373,37,6,336
المتن,الجوار ,صالة كنيسة سيدة البشارة - غرفة رقم 1,مسيحي,616,373,5,0,368
المتن,الخله ,وقف كنيسة مار عبدا - غرفة رقم 1,ماروني,274,211,12,2,199
المتن,الخنشاره ,مدرسة القديس جاورجيوس للراهبات الباسيليات الشويريات - غرفة رقم 1,روم كاثوليك,491,308,4,2,304
المتن,الخنشاره ,مدرسة القديس جاورجيوس للراهبات الباسيليات الشويريات - غرفة رقم 2,روم كاثوليك,290,290,0,1,290
المتن,الخنشاره ,مدرسة القديس جاورجيوس للراهبات الباسيليات الشويريات - غرفة رقم 3,روم كاثوليك,555,319,7,3,312
المتن,الخنشاره ,مدرسة القديس جاورجيوس للراهبات الباسيليات الشويريات - غرفة رقم 4,روم كاثوليك,543,311,2,2,309
المتن,الخنشاره ,مدرسة القديس جاورجيوس للراهبات الباسيليات الشويريات - غرفة رقم 5,مسيحي,546,247,3,1,244
المتن,الدكوانه ,المعهد الفني الصناعي - غرفة رقم 1,ماروني,511,341,3,1,338
المتن,الدكوانه ,المعهد الفني الصناعي - غرفة رقم 2,ماروني,520,246,1,0,245
المتن,الدكوانه ,المعهد الفني الصناعي - غرفة رقم 3,مختلف,538,325,10,2,315
المتن,الدكوانه ,المعهد الفني الصناعي - غرفة رقم 4,مسيحي,547,361,3,3,358
المتن,الدكوانه ,المعهد الفني الصناعي - غرفة رقم 5,ماروني,565,377,9,4,368
المتن,الدكوانه ,المعهد الفني الصناعي - غرفة رقم 6,ماروني,536,243,1,1,242
المتن,الدكوانه ,المعهد الفني الصناعي - غرفة رقم 7,مختلف,613,391,24,1,367
المتن,الدكوانه ,المعهد الفني الصناعي - غرفة رقم 8,مسيحي,566,378,16,1,362
المتن,الدوار ,صالة مار انطونيوس الدوار - غرفة رقم 1,ماروني,415,294,3,0,291
المتن,الدوار ,صالة مار انطونيوس الدوار - غرفة رقم 2,ماروني,434,303,3,2,300
المتن,الديشونيه ,الدار البلدي الجديد في المنصورية - غرفة رقم 6,مسيحي,138,110,0,0,110
المتن,الرابية ,دار البلدية - غرفة رقم 1,مسيحي,475,192,4,0,188
المتن,الزغرين ,صالة كنيسة مار انطونيوس - غرفة رقم 1,ماروني,358,219,2,0,217
المتن,الزلقا ,متوسطة الزلقا الرسمية - غرفة رقم 1,ماروني,497,286,22,0,264
المتن,الزلقا ,متوسطة الزلقا الرسمية - غرفة رقم 2,ماروني,514,308,9,2,299
المتن,الزلقا ,متوسطة الزلقا الرسمية - غرفة رقم 3,ماروني,484,282,7,1,275
المتن,الزلقا ,متوسطة الزلقا الرسمية - غرفة رقم 4,مسيحي,506,284,6,3,278
المتن,الزلقا ,متوسطة الزلقا الرسمية - غرفة رقم 5,مسيحي,521,302,10,7,292
المتن,السفيله ,مدرسة السفيلة الرسمية - غرفة رقم 1,ماروني,267,227,3,0,224
المتن,الشاويه والقنيطره ,صالة كنيسة مار جرجس الشاوية - غرفة رقم 1,ماروني,655,348,1,0,347
المتن,الشوير ,دار بلدية الشوير – عين السنديانه - غرفة رقم 1,روم ارثوذكس,576,274,5,0,269
المتن,الشوير ,دار بلدية الشوير – عين السنديانه - غرفة رقم 2,روم ارثوذكس,560,212,1,1,211
المتن,الشوير ,دار بلدية الشوير – عين السنديانه - غرفة رقم 3,روم كاثوليك,535,271,4,2,267
المتن,الشوير ,دار بلدية الشوير – عين السنديانه - غرفة رقم 4,مسيحي,509,209,2,1,207
المتن,الشوير ,دار بلدية الشوير – عين السنديانه - غرفة رقم 5,روم ارثوذكس,603,272,11,1,261
المتن,الشوير ,دار بلدية الشوير – عين السنديانه - غرفة رقم 6,روم ارثوذكس,592,216,4,2,212
المتن,الشوير ,دار بلدية الشوير – عين السنديانه - غرفة رقم 7,روم كاثوليك,551,298,5,2,293
المتن,الشوير ,دار بلدية الشوير – عين السنديانه - غرفة رقم 8,مسيحي,575,246,2,0,244
المتن,الضبيه ,ثانوية ضبيه الرسمية - غرفة رقم 1,ماروني,523,329,5,2,324
المتن,الضبيه ,ثانوية ضبيه الرسمية - غرفة رقم 2,ماروني,508,325,24,0,301
المتن,الضبيه ,ثانوية ضبيه الرسمية - غرفة رقم 3,مسيحي,549,349,12,1,337
المتن,الضبيه ,ثانوية ضبيه الرسمية - غرفة رقم 4,مسيحي,327,227,4,2,223
المتن,العطشانه ,مركز شرطة بلدية العطشانه - غرفة رقم 1,مسيحي,348,211,3,2,208
المتن,العيرون ,دار البلدية - غرفة رقم 1,ماروني,439,316,2,1,314
المتن,العيون ,مركز البلدية - غرفة رقم 1,ماروني,229,141,1,0,140
المتن,الغابه ,مركز البلدية - غرفة رقم 1,ماروني,249,145,0,0,145
المتن,الفريكه ,بيت الكنيسة مار يوسف - غرفة رقم 1,ماروني,311,191,2,1,189
المتن,الفريكه ,بيت الكنيسة مار يوسف - غرفة رقم 2,ماروني,316,204,1,0,203
المتن,القعقور ,دار البلدية - غرفة رقم 1,ماروني,669,455,2,1,453
المتن,القعقور ,دار البلدية - غرفة رقم 2,ماروني,660,473,9,2,464
المتن,المتين ,المدرسة الرسمية - غرفة رقم 1,ماروني,554,340,3,3,337
المتن,المتين ,المدرسة الرسمية - غرفة رقم 2,ماروني,549,325,3,1,322
المتن,المتين ,المدرسة الرسمية - غرفة رقم 3,ماروني,544,325,0,1,325
المتن,المتين ,المدرسة الرسمية - غرفة رقم 4,ماروني,548,327,1,3,326
المتن,المتين ,المدرسة الرسمية - غرفة رقم 5,ماروني,508,101,7,0,94
المتن,المتين ,المدرسة الرسمية - غرفة رقم 6,مختلف,550,276,7,0,269
المتن,المتين ,المدرسة الرسمية - غرفة رقم 7,مختلف,557,212,11,1,201
المتن,المتين موظفون ,سراي الجديدة - غرفة رقم 1,مختلف,196,180,0,1,180
المتن,المحيدثة ,المدرسة الرسمية - غرفة رقم 1,روم ارثوذكس,504,214,3,1,211
المتن,المحيدثة ,المدرسة الرسمية - غرفة رقم 2,روم ارثوذكس,556,243,3,0,240
المتن,المروج ,دير راهبات القلبين الاقدسين - غرفة رقم 1,ماروني,559,425,13,3,412
المتن,المروج ,دير راهبات القلبين الاقدسين - غرفة رقم 2,ماروني,567,402,4,2,398
المتن,المروج ,دير راهبات القلبين الاقدسين - غرفة رقم 3,مسيحي,563,361,8,0,353
المتن,المسقى ,صالون كنيسة بلدة المسقى مار تقلا - غرفة رقم 1,ماروني,409,221,4,0,217
المتن,المشرع ,صالون كنيسة مار شليطا – عين القبو - غرفة رقم 2,مسيحي,123,57,1,0,56
المتن,المطيلب ,قاعة كنيسة مار يوسف - غرفة رقم 1,مسيحي,528,346,5,0,341
المتن,المكلس ,الدار البلدي الجديد في المنصورية - غرفة رقم 5,مسيحي,310,180,0,1,180
المتن,المنصوريه ,الدار البلدي الجديد في المنصورية - غرفة رقم 1,روم ارثوذكس,484,302,23,1,279
المتن,المنصوريه ,الدار البلدي الجديد في المنصورية - غرفة رقم 2,مسيحي,512,207,13,1,194
المتن,المنصوريه ,الدار البلدي الجديد في المنصورية - غرفة رقم 3,روم ارثوذكس,556,337,14,5,323
المتن,المنصوريه ,الدار البلدي الجديد في المنصورية - غرفة رقم 4,مسيحي,546,217,3,1,214
المتن,المياسه ,صالة كنيسة مار يوسف - غرفة رقم 1,ماروني,414,309,2,1,307
المتن,المياسه ,صالة كنيسة مار يوسف - غرفة رقم 2,ماروني,444,347,0,1,347
المتن,النقاش ,التكميلية الرسمية - غرفة رقم 10,مسيحي,410,230,1,0,229
المتن,النقاش ,التكميلية الرسمية - غرفة رقم 9,مسيحي,362,209,6,2,203
المتن,انطلياس ,التكميلية الرسمية - غرفة رقم 1,ماروني,549,308,9,2,299
المتن,انطلياس ,التكميلية الرسمية - غرفة رقم 2,مسيحي,560,334,18,1,316
المتن,انطلياس ,التكميلية الرسمية - غرفة رقم 3,روم ارثوذكس,571,363,8,8,355
المتن,انطلياس ,التكميلية الرسمية - غرفة رقم 4,أرمن ارثوذكس,542,186,9,2,177
المتن,انطلياس ,التكميلية الرسمية - غرفة رقم 5,ماروني,564,313,10,0,303
المتن,انطلياس ,التكميلية الرسمية - غرفة رقم 6,مسيحي,604,382,1,3,381
المتن,انطلياس ,التكميلية الرسمية - غرفة رقم 7,مسيحي,595,359,6,3,353
المتن,انطلياس ,التكميلية الرسمية - غرفة رقم 8,أرمن ارثوذكس,577,194,3,1,191
المتن,بتغرين ,المدرسة الرسمية - غرفة رقم 1,روم ارثوذكس,552,408,0,3,408
المتن,بتغرين ,المدرسة الرسمية - غرفة رقم 2,روم ارثوذكس,555,384,3,0,381
المتن,بتغرين ,المدرسة الرسمية - غرفة رقم 3,مسيحي,562,338,4,2,334
المتن,بتغرين ,المدرسة الرسمية - غرفة رقم 4,روم ارثوذكس,562,434,10,3,424
المتن,بتغرين ,المدرسة الرسمية - غرفة رقم 5,روم ارثوذكس,577,378,4,2,374
المتن,بتغرين ,المدرسة الرسمية - غرفة رقم 6,مسيحي,560,349,0,3,349
المتن,بحر صاف ,صالون كنيسة مار يوحنا - غرفة رقم 1,ماروني,364,226,2,0,224
المتن,بحر صاف ,صالون كنيسة مار يوحنا - غرفة رقم 2,ماروني,420,235,5,3,230
المتن,برج حمود ,دار البلدية - غرفة رقم 1,أرمن ارثوذكس,594,253,11,2,242
المتن,برج حمود ,دار البلدية - غرفة رقم 2,أرمن ارثوذكس,612,266,7,3,259
المتن,برج حمود ,دار البلدية - غرفة رقم 3,أرمن ارثوذكس,541,282,2,0,280
المتن,برج حمود ,دار البلدية - غرفة رقم 4,أرمن ارثوذكس,576,253,7,4,246
المتن,برج حمود ,دار البلدية - غرفة رقم 5,أرمن ارثوذكس,654,282,14,2,268
المتن,برج حمود ,دار البلدية - غرفة رقم 6,أرمن ارثوذكس,648,278,10,4,268
المتن,برج حمود ,دار البلدية - غرفة رقم 7,أرمن ارثوذكس,588,274,0,2,274
المتن,برج حمود ,دار البلدية - غرفة رقم 8,أرمن ارثوذكس,609,268,9,6,259
المتن,برج حمود ,مدرسة اكسور كسارجيان - غرفة رقم 1,سني,640,228,13,2,215
المتن,برج حمود ,مدرسة اكسور كسارجيان - غرفة رقم 2,سريان ارثوذكس,431,141,7,1,134
المتن,برج حمود ,مدرسة اكسور كسارجيان - غرفة رقم 3,مسيحي,432,144,3,0,141
المتن,برج حمود ,مدرسة الأربعين شهيد - غرفة رقم 1,شيعي,549,250,3,0,247
المتن,برج حمود ,مدرسة الأربعين شهيد - غرفة رقم 2,شيعي,540,320,4,1,316
المتن,برج حمود ,مدرسة الأربعين شهيد - غرفة رقم 3,ماروني,538,292,11,5,281
المتن,برج حمود ,مدرسة الأربعين شهيد - غرفة رقم 4,مختلف,541,265,12,5,253
المتن,برج حمود ,مدرسة الأربعين شهيد - غرفة رقم 5,شيعي,547,112,9,4,103
المتن,برج حمود ,مدرسة الأربعين شهيد - غرفة رقم 6,شيعي,572,217,2,4,215
المتن,برج حمود ,مدرسة الأربعين شهيد - غرفة رقم 7,ماروني,551,298,8,5,290
المتن,برج حمود ,مدرسة الأربعين شهيد - غرفة رقم 8,مختلف,551,276,20,5,256
المتن,برج حمود ,مدرسة الأربعين شهيد - غرفة رقم 9,مسيحي,559,274,17,3,257
المتن,برج حمود ,مدرسة شامليان - غرفة رقم 1,أرمن ارثوذكس,515,62,2,2,60
المتن,برج حمود ,مدرسة شامليان - غرفة رقم 10,أرمن ارثوذكس,536,113,0,1,113
المتن,برج حمود ,مدرسة شامليان - غرفة رقم 11,أرمن ارثوذكس,552,119,3,1,116
المتن,برج حمود ,مدرسة شامليان - غرفة رقم 12,أرمن ارثوذكس,544,98,0,0,98
المتن,برج حمود ,مدرسة شامليان - غرفة رقم 13,أرمن ارثوذكس,528,128,3,4,125
المتن,برج حمود ,مدرسة شامليان - غرفة رقم 2,أرمن ارثوذكس,512,78,0,0,78
المتن,برج حمود ,مدرسة شامليان - غرفة رقم 3,أرمن ارثوذكس,519,115,3,1,112
المتن,برج حمود ,مدرسة شامليان - غرفة رقم 4,أرمن ارثوذكس,526,124,2,0,122
المتن,برج حمود ,مدرسة شامليان - غرفة رقم 5,أرمن ارثوذكس,513,104,1,1,103
المتن,برج حمود ,مدرسة شامليان - غرفة رقم 6,أرمن ارثوذكس,536,125,1,1,124
المتن,برج حمود ,مدرسة شامليان - غرفة رقم 7,أرمن ارثوذكس,528,105,0,1,105
المتن,برج حمود ,مدرسة شامليان - غرفة رقم 8,أرمن ارثوذكس,538,70,0,4,70
المتن,برج حمود ,مدرسة شامليان - غرفة رقم 9,أرمن ارثوذكس,513,79,4,0,75
المتن,برج حمود ,مدرسة كيليكيان المعروفة بأبكاريان - غرفة رقم 1,أرمن كاثوليك,522,150,0,2,150
المتن,برج حمود ,مدرسة كيليكيان المعروفة بأبكاريان - غرفة رقم 10,أرمن كاثوليك,571,187,6,2,181
المتن,برج حمود ,مدرسة كيليكيان المعروفة بأبكاريان - غرفة رقم 2,أرمن كاثوليك,521,113,4,1,109
المتن,برج حمود ,مدرسة كيليكيان المعروفة بأبكاريان - غرفة رقم 3,أرمن كاثوليك,519,87,1,1,86
المتن,برج حمود ,مدرسة كيليكيان المعروفة بأبكاريان - غرفة رقم 4,أرمن كاثوليك,524,69,2,0,67
المتن,برج حمود ,مدرسة كيليكيان المعروفة بأبكاريان - غرفة رقم 5,أرمن كاثوليك,555,155,2,1,153
المتن,برج حمود ,مدرسة كيليكيان المعروفة بأبكاريان - غرفة رقم 6,أرمن كاثوليك,559,119,7,2,112
المتن,برج حمود ,مدرسة كيليكيان المعروفة بأبكاريان - غرفة رقم 7,أرمن كاثوليك,568,103,0,1,103
المتن,برج حمود ,مدرسة كيليكيان المعروفة بأبكاريان - غرفة رقم 8,أرمن كاثوليك,553,88,2,1,86
المتن,برج حمود ,مدرسة كيليكيان المعروفة بأبكاريان - غرفة رقم 9,أرمن كاثوليك,530,195,5,3,190
المتن,برج حمود ,مدرسة مار يوسف - غرفة رقم 1,إنجيلي,594,185,3,0,182
المتن,برج حمود ,مدرسة مار يوسف - غرفة رقم 10,روم ارثوذكس,586,104,2,0,102
المتن,برج حمود ,مدرسة مار يوسف - غرفة رقم 11,مسيحي,602,203,5,0,198
المتن,برج حمود ,مدرسة مار يوسف - غرفة رقم 12,مسيحي,584,170,2,3,168
المتن,برج حمود ,مدرسة مار يوسف - غرفة رقم 2,روم كاثوليك,604,316,7,1,309
المتن,برج حمود ,مدرسة مار يوسف - غرفة رقم 3,مسيحي,562,151,1,0,150
المتن,برج حمود ,مدرسة مار يوسف - غرفة رقم 4,إنجيلي,593,315,9,3,306
المتن,برج حمود ,مدرسة مار يوسف - غرفة رقم 5,روم كاثوليك,560,196,13,1,183
المتن,برج حمود ,مدرسة مار يوسف - غرفة رقم 6,مسيحي,604,207,6,4,201
المتن,برج حمود ,مدرسة مار يوسف - غرفة رقم 7,روم ارثوذكس,557,121,1,1,120
المتن,برج حمود ,مدرسة مار يوسف - غرفة رقم 8,روم ارثوذكس,563,192,1,0,191
المتن,برج حمود ,مدرسة مار يوسف - غرفة رقم 9,روم ارثوذكس,547,173,4,1,169
المتن,برج حمود ,مدرسة مسروبيان - غرفة رقم 1,أرمن ارثوذكس,536,171,2,2,169
المتن,برج حمود ,مدرسة مسروبيان - غرفة رقم 10,أرمن ارثوذكس,550,167,12,0,155
المتن,برج حمود ,مدرسة مسروبيان - غرفة رقم 11,أرمن ارثوذكس,535,150,1,4,149
المتن,برج حمود ,مدرسة مسروبيان - غرفة رقم 12,أرمن ارثوذكس,554,165,3,2,162
المتن,برج حمود ,مدرسة مسروبيان - غرفة رقم 13,أرمن ارثوذكس,541,124,3,1,121
المتن,برج حمود ,مدرسة مسروبيان - غرفة رقم 14,أرمن ارثوذكس,557,100,2,0,98
المتن,برج حمود ,مدرسة مسروبيان - غرفة رقم 15,أرمن ارثوذكس,547,92,11,0,81
المتن,برج حمود ,مدرسة مسروبيان - غرفة رقم 2,أرمن ارثوذكس,513,154,5,4,149
المتن,برج حمود ,مدرسة مسروبيان - غرفة رقم 3,أرمن ارثوذكس,529,139,2,1,137
المتن,برج حمود ,مدرسة مسروبيان - غرفة رقم 4,أرمن ارثوذكس,547,173,2,2,171
المتن,برج حمود ,مدرسة مسروبيان - غرفة رقم 5,أرمن ارثوذكس,535,151,1,3,150
المتن,برج حمود ,مدرسة مسروبيان - غرفة رقم 6,أرمن ارثوذكس,529,139,2,1,137
المتن,برج حمود ,مدرسة مسروبيان - غرفة رقم 7,أرمن ارثوذكس,526,111,3,1,108
المتن,برج حمود ,مدرسة مسروبيان - غرفة رقم 8,أرمن ارثوذكس,556,179,9,4,170
المتن,برج حمود ,مدرسة مسروبيان - غرفة رقم 9,أرمن ارثوذكس,555,154,3,5,151
المتن,برمانا ,المدرسة الرسمية - غرفة رقم 1,ماروني,489,235,3,1,232
المتن,برمانا ,المدرسة الرسمية - غرفة رقم 2,ماروني,507,251,5,0,246
المتن,برمانا ,المدرسة الرسمية - غرفة رقم 3,روم ارثوذكس,503,229,1,2,228
المتن,برمانا ,المدرسة الرسمية - غرفة رقم 4,روم ارثوذكس,568,258,8,2,250
المتن,برمانا ,المدرسة الرسمية - غرفة رقم 5,مسيحي,518,209,6,1,203
المتن,برمانا ,المدرسة الرسمية - غرفة رقم 6,مسيحي,554,216,10,3,206
المتن,بسكنتا جنوبي ,راهبات المحبة مار منصور - غرفة رقم 1,ماروني,526,343,2,7,341
المتن,بسكنتا جنوبي ,راهبات المحبة مار منصور - غرفة رقم 2,ماروني,567,351,27,3,324
المتن,بسكنتا جنوبي ,راهبات المحبة مار منصور - غرفة رقم 3,مسيحي,543,269,2,0,267
المتن,بسكنتا جنوبي ,راهبات المحبة مار منصور - غرفة رقم 4,ماروني,567,367,25,0,342
المتن,بسكنتا جنوبي ,راهبات المحبة مار منصور - غرفة رقم 5,ماروني,573,365,4,1,361
المتن,بسكنتا جنوبي ,راهبات المحبة مار منصور - غرفة رقم 6,مسيحي,542,299,2,2,297
المتن,بسكنتا شمالي ,المدرسة التكميلية الرسمية - غرفة رقم 1,روم ارثوذكس,551,332,12,1,320
المتن,بسكنتا شمالي ,المدرسة التكميلية الرسمية - غرفة رقم 2,روم ارثوذكس,553,319,8,2,311
المتن,بسكنتا شمالي ,المدرسة التكميلية الرسمية - غرفة رقم 3,ماروني,570,399,2,2,397
المتن,بسكنتا شمالي ,المدرسة التكميلية الرسمية - غرفة رقم 4,ماروني,595,430,8,3,422
المتن,بسكنتا شمالي ,المدرسة التكميلية الرسمية - غرفة رقم 5,مسيحي,574,351,7,2,344
المتن,بسكنتا شمالي ,المدرسة التكميلية الرسمية - غرفة رقم 6,مسيحي,592,338,8,1,330
المتن,بصاليم ,دار البلدية - غرفة رقم 1,مسيحي,531,391,5,0,386
المتن,بصاليم ,دار البلدية - غرفة رقم 2,مسيحي,561,391,3,1,388
المتن,بعبدات ,مبنى البلدية - غرفة رقم 1,ماروني,505,274,6,4,268
المتن,بعبدات ,مبنى البلدية - غرفة رقم 2,مسيحي,506,258,9,1,249
المتن,بعبدات ,مبنى البلدية - غرفة رقم 3,ماروني,543,303,6,8,297
المتن,بعبدات ,مبنى البلدية - غرفة رقم 4,مسيحي,561,265,8,2,257
المتن,بقنايا ,مركز الجمعية الخيرية - غرفة رقم 1,مسيحي,364,200,1,3,199
المتن,بقنايا ,مركز الجمعية الخيرية - غرفة رقم 2,مسيحي,309,171,4,0,167
المتن,بكفيا ,ثانوية بكفيا الرسمية - غرفة رقم 1,ماروني,522,251,1,2,250
المتن,بكفيا ,ثانوية بكفيا الرسمية - غرفة رقم 2,ماروني,516,248,1,1,247
المتن,بكفيا ,ثانوية بكفيا الرسمية - غرفة رقم 3,ماروني,507,140,3,1,137
المتن,بكفيا ,ثانوية بكفيا الرسمية - غرفة رقم 4,ماروني,524,261,5,3,256
المتن,بكفيا ,ثانوية بكفيا الرسمية - غرفة رقم 5,ماروني,525,236,4,1,232
المتن,بكفيا ,ثانوية بكفيا الرسمية - غرفة رقم 6,ماروني,516,146,2,3,144
المتن,بكفيا ,ثانوية بكفيا الرسمية - غرفة رقم 7,ماروني,505,241,4,1,237
المتن,بكفيا ,ثانوية بكفيا الرسمية - غرفة رقم 8,مسيحي,474,143,1,0,142
المتن,بكفيا ,ثانوية بكفيا الرسمية - غرفة رقم 9,مسيحي,533,178,7,0,171
المتن,بياقوت ,مدرسة عقبة بياقوت الرسمية - غرفة رقم 1,مسيحي,334,243,4,0,239
المتن,بياقوت ,مدرسة عقبة بياقوت الرسمية - غرفة رقم 2,مسيحي,334,245,4,2,241
المتن,بيت الشعار ,دار البلدية - غرفة رقم 1,ماروني,457,253,4,0,249
المتن,بيت الشعار ,دار البلدية - غرفة رقم 2,ماروني,528,290,3,2,287
المتن,بيت الككو ,صالون كنيسة بيت الككو - غرفة رقم 1,ماروني,346,172,0,0,172
المتن,بيت شباب تحتاني ,دار البلدية - غرفة رقم 1,ماروني,508,294,15,1,279
المتن,بيت شباب تحتاني ,دار البلدية - غرفة رقم 2,ماروني,528,265,14,0,251
المتن,بيت شباب تحتاني ,دار البلدية - غرفة رقم 3,ماروني,515,221,9,0,212
المتن,بيت شباب تحتاني ,مدرسة بيت شباب الرسمية - غرفة رقم 1,ماروني,512,119,0,0,119
المتن,بيت شباب تحتاني ,مدرسة بيت شباب الرسمية - غرفة رقم 2,ماروني,571,306,12,2,294
المتن,بيت شباب تحتاني ,مدرسة بيت شباب الرسمية - غرفة رقم 3,ماروني,556,251,1,1,250
المتن,بيت شباب تحتاني ,مدرسة بيت شباب الرسمية - غرفة رقم 4,ماروني,535,230,0,0,230
المتن,بيت شباب تحتاني ,مدرسة بيت شباب الرسمية - غرفة رقم 5,ماروني,545,142,0,0,142
المتن,بيت شباب فوقاني ,دير مار انطونيوس - غرفة رقم 1,ماروني,446,245,8,3,237
المتن,بيت شباب فوقاني ,دير مار انطونيوس - غرفة رقم 2,ماروني,442,242,3,2,239
المتن,بيت شباب فوقاني ,دير مار انطونيوس - غرفة رقم 3,ماروني,429,241,4,0,237
المتن,بيت مري ,"الثانوية الرسمية مركزها في مدرسة الفرير سابقا"" - غرفة رقم 1",مختلف,533,177,1,1,176
المتن,بيت مري ,"الثانوية الرسمية مركزها في مدرسة الفرير سابقا"" - غرفة رقم 2",مختلف,565,205,3,0,202
المتن,بيت مري ,"الثانوية الرسمية مركزها في مدرسة الفرير سابقا"" - غرفة رقم 3",ماروني,493,330,3,0,327
المتن,بيت مري ,"الثانوية الرسمية مركزها في مدرسة الفرير سابقا"" - غرفة رقم 4",ماروني,493,251,8,3,243
المتن,بيت مري ,"الثانوية الرسمية مركزها في مدرسة الفرير سابقا"" - غرفة رقم 5",ماروني,505,328,14,0,314
المتن,بيت مري ,"الثانوية الرسمية مركزها في مدرسة الفرير سابقا"" - غرفة رقم 6",ماروني,488,260,3,1,257
المتن,بيت مري ,"الثانوية الرسمية مركزها في مدرسة الفرير سابقا"" - غرفة رقم 7",ماروني,510,188,2,2,186
المتن,جل الديب ,متوسطة جل الديب الرسمية - غرفة رقم 1,ماروني,499,281,1,2,280
المتن,جل الديب ,متوسطة جل الديب الرسمية - غرفة رقم 2,ماروني,491,306,3,4,303
المتن,جل الديب ,متوسطة جل الديب الرسمية - غرفة رقم 3,مسيحي,501,284,2,1,282
المتن,جل الديب ,متوسطة جل الديب الرسمية - غرفة رقم 4,مسيحي,473,144,1,2,143
المتن,جل الديب ,متوسطة جل الديب الرسمية - غرفة رقم 5,ماروني,558,318,12,0,306
المتن,جل الديب ,متوسطة جل الديب الرسمية - غرفة رقم 6,ماروني,543,317,0,3,317
المتن,جل الديب ,متوسطة جل الديب الرسمية - غرفة رقم 7,مسيحي,559,314,11,3,303
المتن,جل الديب ,متوسطة جل الديب الرسمية - غرفة رقم 8,مسيحي,489,144,1,3,143
المتن,جورة البلوط ,المدرسة القديمة قرب الكنيسة - غرفة رقم 1,ماروني,398,229,5,1,224
المتن,جورة البلوط ,المدرسة القديمة قرب الكنيسة - غرفة رقم 2,ماروني,404,234,9,2,225
المتن,حملايا ,صالة مار الياس - غرفة رقم 1,ماروني,530,349,2,4,347
المتن,حملايا ,صالة مار جرجس - غرفة رقم 1,ماروني,580,347,4,3,343
المتن,دول إقليمية,دول إقليمية,مختلف,4633,2822,44,9,2778
المتن,دير شمرا ,صالون كنيسة البلدة – دير مار يوسف - غرفة رقم 1,ماروني,213,179,2,0,177
المتن,ديك المحدي ,دار البلدية - غرفة رقم 1,ماروني,492,240,14,0,226
المتن,روميه ,مدرسة مار ضومط - غرفة رقم 1,ماروني,421,261,1,0,260
المتن,روميه ,مدرسة مار ضومط - غرفة رقم 2,مسيحي,395,234,3,2,231
المتن,روميه ,مدرسة مار ضومط - غرفة رقم 3,ماروني,469,291,10,2,281
المتن,روميه ,مدرسة مار ضومط - غرفة رقم 4,مسيحي,455,252,7,0,245
المتن,زبوغا ,وقف كنيسة مار جرجس - غرفة رقم 1,مسيحي,327,176,0,0,176
المتن,زبوغا ,وقف كنيسة مار جرجس - غرفة رقم 2,مسيحي,310,161,5,0,156
المتن,زرعون ,دار البلدية - غرفة رقم 1,مختلف,327,181,1,2,180
المتن,زرعون ,دار البلدية - غرفة رقم 2,مختلف,358,165,3,0,162
المتن,زكريت ,دار البلدية الجديد زكريت - غرفة رقم 1,ماروني,489,309,6,1,303
المتن,زكريت ,دار البلدية الجديد زكريت - غرفة رقم 2,ماروني,483,325,6,3,319
المتن,زوق الخراب ومار يوسف ,ثانوية ضبيه الرسمية - غرفة رقم 4,مسيحي,531,281,1,1,280
المتن,زوق الخراب ومار يوسف ,ثانوية ضبيه الرسمية - غرفة رقم 5,مسيحي,558,303,0,2,303
المتن,زوق الخراب ومار يوسف ,ثانوية ضبيه الرسمية - غرفة رقم 6,مسيحي,518,197,13,0,184
المتن,ساقية المسك ,دير راهبات العائلة المقدسة - غرفة رقم 1,ماروني,547,348,2,2,346
المتن,ساقية المسك ,دير راهبات العائلة المقدسة - غرفة رقم 2,ماروني,546,348,7,1,341
المتن,ساقية المسك ,دير راهبات العائلة المقدسة - غرفة رقم 3,مسيحي,529,262,2,1,260
المتن,سد البوشريه ,المدرسة الرسمية للبنات - غرفة رقم 1,ماروني,550,335,3,1,332
المتن,سد البوشريه ,المدرسة الرسمية للبنات - غرفة رقم 2,مختلف,549,312,3,4,309
المتن,سد البوشريه ,المدرسة الرسمية للبنات - غرفة رقم 3,مسيحي,551,244,3,1,241
المتن,سد البوشريه ,المدرسة الرسمية للبنات - غرفة رقم 4,ماروني,562,338,7,4,331
المتن,سد البوشريه ,المدرسة الرسمية للبنات - غرفة رقم 5,مختلف,621,347,15,1,332
المتن,سد البوشريه ,المدرسة الرسمية للبنات - غرفة رقم 6,مسيحي,549,246,20,2,226
المتن,سد البوشريه ,المدرسة الرسمية للصبيان - غرفة رقم 1,سريان ارثوذكس,536,174,1,0,173
المتن,سد البوشريه ,المدرسة الرسمية للصبيان - غرفة رقم 2,سريان ارثوذكس,523,209,8,4,201
المتن,سد البوشريه ,المدرسة الرسمية للصبيان - غرفة رقم 3,مختلف,561,247,10,1,237
المتن,سد البوشريه ,المدرسة الرسمية للصبيان - غرفة رقم 4,مختلف,586,260,12,1,248
المتن,سد البوشريه ,المدرسة الرسمية للصبيان - غرفة رقم 5,مسيحي,553,251,3,1,248
المتن,سد البوشريه ,المدرسة الرسمية للصبيان - غرفة رقم 6,مسيحي,542,259,3,1,256
المتن,سن الفيل حي البلده ,مدرسة سن الفيل الاولى الرسمية - غرفة رقم 1,ماروني,521,306,7,0,299
المتن,سن الفيل حي البلده ,مدرسة سن الفيل الاولى الرسمية - غرفة رقم 2,ماروني,507,259,12,2,247
المتن,سن الفيل حي البلده ,مدرسة سن الفيل الاولى الرسمية - غرفة رقم 3,ماروني,542,311,8,3,303
المتن,سن الفيل حي البلده ,مدرسة سن الفيل الاولى الرسمية - غرفة رقم 4,ماروني,563,281,7,1,274
المتن,سن الفيل حي البلده ,مدرسة سن الفيل الاولى الرسمية - غرفة رقم 5,مسيحي,510,252,9,0,243
المتن,سن الفيل حي البلده ,مدرسة سن الفيل الاولى الرسمية - غرفة رقم 6,مسيحي,522,248,8,1,240
المتن,سن الفيل حي البلده ,مدرسة سن الفيل الاولى الرسمية - غرفة رقم 7,روم ارثوذكس,505,280,4,0,276
المتن,سن الفيل حي البلده ,مدرسة سن الفيل الاولى الرسمية - غرفة رقم 8,روم ارثوذكس,570,298,0,0,298
المتن,سن الفيل حي البلده ,مدرسة سن الفيل الاولى الرسمية - غرفة رقم 9,مسيحي,563,255,4,2,251
المتن,سن الفيل حي الجديد ,مدرسة سن الفيل الاولى الرسمية - غرفة رقم 10,مختلف,543,208,11,2,197
المتن,سن الفيل حي الجديد ,مدرسة سن الفيل الاولى الرسمية - غرفة رقم 11,مختلف,490,191,21,8,170
المتن,سن الفيل حي الجديد ,مدرسة سن الفيل الاولى الرسمية - غرفة رقم 12,مسيحي,508,215,9,3,206
المتن,سن الفيل حي الحرج ,مدرسة سن الفيل الاولى الرسمية - غرفة رقم 13,مختلف,460,236,4,0,232
المتن,سن الفيل حي الحرج ,مدرسة سن الفيل الاولى الرسمية - غرفة رقم 14,مسيحي,474,250,1,0,249
المتن,سن الفيل حي الحرج ,مدرسة سن الفيل الاولى الرسمية - غرفة رقم 15,مسيحي,453,222,7,0,215
المتن,سن الفيل حي جسر الباشا ,مبنى جامعة AUL - غرفة رقم 1,ماروني,426,238,3,1,235
المتن,سن الفيل حي جسر الباشا ,مبنى جامعة AUL - غرفة رقم 2,مسيحي,422,180,1,0,179
المتن,سن الفيل حي جسر الباشا ,مبنى جامعة AUL - غرفة رقم 3,ماروني,471,269,5,2,264
المتن,سن الفيل حي جسر الباشا ,مبنى جامعة AUL - غرفة رقم 4,مسيحي,458,222,4,4,218
المتن,شرين ,النادي الرياضي في شرين - غرفة رقم 1,روم ارثوذكس,297,184,4,0,180
المتن,شرين ,النادي الرياضي في شرين - غرفة رقم 2,روم ارثوذكس,317,228,0,1,228
المتن,شويا ,صالون كنيسة سيدة البشارة - غرفة رقم 1,ماروني,385,260,0,2,260
المتن,ضهر الصوان ,مبنى البلدية - غرفة رقم 1,مسيحي,432,258,0,2,258
المتن,ضهر الصوان ,مبنى البلدية - غرفة رقم 2,مسيحي,468,288,5,2,283
المتن,عمارة شلهوب ,مركز شرطة البلدية - غرفة رقم 1,مسيحي,485,282,4,0,278
المتن,عمارة شلهوب ,مركز شرطة البلدية - غرفة رقم 2,مختلف,467,263,8,2,255
المتن,عمارة شلهوب ,مركز شرطة البلدية - غرفة رقم 3,مسيحي,471,224,3,1,221
المتن,عين التفاحة ,صالون كنيسة مار جرجس - غرفة رقم 1,ماروني,237,193,1,0,192
المتن,عين الخروبه ,مدرسة راهبات القلبين الاقدسين - غرفة رقم 1,ماروني,503,393,16,2,377
المتن,عين الخروبه ,مدرسة راهبات القلبين الاقدسين - غرفة رقم 2,ماروني,497,386,0,2,386
المتن,عين الزيتونه ,بيت جاهز في ساحة البلدة - غرفة رقم 1,ماروني,202,131,5,0,126
المتن,عين السنديانه ,وقف كنيسة مار تقلا - غرفة رقم 1,روم ارثوذكس,311,148,2,2,146
المتن,عين السنديانه ,وقف كنيسة مار تقلا - غرفة رقم 2,روم ارثوذكس,330,174,9,0,165
المتن,عين الصفصاف ,صالة كنيسة مار الياس الحي - غرفة رقم 1,روم كاثوليك,585,364,3,0,361
المتن,عين القبو ودير مار سمعان ,صالة كنيسة مار شليطا - غرفة رقم 1,ماروني,216,93,0,1,93
المتن,عين سعادة ,مركز البلدية الجديد - غرفة رقم 1,ماروني,565,307,4,2,303
المتن,عين سعادة ,مركز البلدية الجديد - غرفة رقم 2,ماروني,601,351,19,1,332
المتن,عين عار ,صالون كنيسة مار الياس (عين عار) - غرفة رقم 1,ماروني,324,155,2,2,153
المتن,عين عار ,صالون كنيسة مار الياس (عين عار) - غرفة رقم 2,ماروني,340,161,9,0,152
المتن,عين علق ,كنيسة الخلاص - غرفة رقم 1,ماروني,408,243,1,2,242
المتن,عينطوره ,دار البلدية - غرفة رقم 1,ماروني,617,397,8,2,389
المتن,عينطوره ,دار البلدية - غرفة رقم 2,ماروني,626,414,15,1,399
المتن,عينطوره ,دار البلدية - غرفة رقم 3,ماروني,606,313,12,0,301
المتن,عينطوره ,مدرسة سيدة المعونات - غرفة رقم 1,ماروني,606,368,13,2,355
المتن,عينطوره ,مدرسة سيدة المعونات - غرفة رقم 2,ماروني,602,382,7,0,375
المتن,عينطوره ,مدرسة سيدة المعونات - غرفة رقم 3,ماروني,605,296,5,0,291
المتن,فنار ,دار البلدية - غرفة رقم 1,مسيحي,438,291,3,2,288
المتن,فنار ,دار البلدية - غرفة رقم 2,مسيحي,499,326,2,2,324
المتن,قرنة الحمرا ,القاعة العامة - غرفة رقم 1,ماروني,382,239,3,0,236
المتن,قرنة الحمرا ,القاعة العامة - غرفة رقم 2,ماروني,404,261,5,2,256
المتن,قرنة الحمرا ,القاعة العامة - غرفة رقم 3,ماروني,416,148,5,0,143
المتن,قرنة شهوان ,دار البلدية - غرفة رقم 1,ماروني,412,181,1,2,180
المتن,قرنة شهوان ,دار البلدية - غرفة رقم 2,ماروني,404,205,2,2,203
المتن,قرنة شهوان ,دار البلدية - غرفة رقم 3,مسيحي,414,159,4,1,155
المتن,قنابة برمانا ,دار البلدية - غرفة رقم 1,روم ارثوذكس,355,154,11,1,143
المتن,قنابة صليما ,بيت جاهز في ساحة كنيسة مار عبدا - غرفة رقم 1,ماروني,154,105,0,0,105
المتن,كفر عقاب ,مركز نادي الجمعية الخيرية الارثوذكسية - غرفة رقم 1,مسيحي,286,125,2,0,123
المتن,كفر عقاب ,مركز نادي الجمعية الخيرية الارثوذكسية - غرفة رقم 2,مسيحي,345,153,3,1,150
المتن,كفرتيه ,مدرسة البلدة - غرفة رقم 1,مسيحي,310,188,1,0,187
المتن,مار بطرس كرم التين ,صالة كنيسة الرب - غرفة رقم 1,ماروني,343,282,10,3,272
المتن,مار شعيا والمزكه ,دار البلدية - غرفة رقم 1,ماروني,289,185,1,1,184
المتن,مار مخايل بنابيل ,صالة جمعية مار مخايل بنابيل - غرفة رقم 1,ماروني,315,230,1,0,229
المتن,مار موسى الدوار ,القاعة العامة - غرفة رقم 1,ماروني,315,204,0,1,204
المتن,مجدل ترشيش ,مركز البلدية - غرفة رقم 1,شيعي,545,370,5,2,365
المتن,مرجبا ,دار البلدية - غرفة رقم 1,ماروني,641,507,12,1,495
المتن,مزرعة بنابيل ,صالة كنيسة السيدة بنابيل - غرفة رقم 1,ماروني,116,71,0,0,71
المتن,مزرعة يشوع ,ثانوية مزرعة يشوع الرسمية - غرفة رقم 1,ماروني,508,329,4,2,325
المتن,مزرعة يشوع ,ثانوية مزرعة يشوع الرسمية - غرفة رقم 2,ماروني,511,361,3,0,358
المتن,مزرعة يشوع ,ثانوية مزرعة يشوع الرسمية - غرفة رقم 3,مسيحي,515,162,2,0,160
المتن,مزهر ومجدوب ,دار البلدية - غرفة رقم 3,مسيحي,607,357,18,1,339
المتن,مشيخا ,صالون كنيسة البلدة - غرفة رقم 1,ماروني,279,179,1,0,178
المتن,نابيه ,قاعة كنيسة مار مخايل للروم الارثودكس - غرفة رقم 1,روم ارثوذكس,522,340,9,2,331
المتن,نابيه ,قاعة كنيسة مار مخايل للروم الارثودكس - غرفة رقم 2,مسيحي,540,355,28,2,327
المتن,نابيه ,قاعة كنيسة مار مخايل للروم الارثودكس - غرفة رقم 3,روم ارثوذكس,530,356,9,6,347
المتن,نابيه ,قاعة كنيسة مار مخايل للروم الارثودكس - غرفة رقم 4,مسيحي,516,346,9,1,337
المتن,وادي الكرم ,كنيسة وقف دير مار سمعان - غرفة رقم 1,مسيحي,390,276,2,1,274
المتن,وادي شاهين ,ثانوية بكفيا الرسمية - غرفة رقم 10,ماروني,40,23,0,0,23
المتن,وطى المروج ,دار البلدية - غرفة رقم 1,مسيحي,334,224,4,3,220
المتن,وطى المروج ,دار البلدية - غرفة رقم 2,مسيحي,329,230,0,2,230
المنية,الريحانية ,المدرسة الرسمية - غرفة رقم 1,سني,564,386,8,0,378
المنية,المنية ,تكميلية البلاط الرسمية - غرفة رقم 1,سني,678,333,6,3,327
المنية,المنية ,تكميلية البلاط الرسمية - غرفة رقم 2,سني,670,308,18,6,290
المنية,المنية ,تكميلية البلاط الرسمية - غرفة رقم 3,سني,674,285,5,5,280
المنية,المنية ,تكميلية البلاط الرسمية - غرفة رقم 4,سني,661,307,18,2,289
المنية,المنية ,تكميلية البلاط الرسمية - غرفة رقم 5,سني,689,307,18,4,289
المنية,المنية ,تكميلية المقالع الرسمية - غرفة رقم 1,سني,687,343,6,7,337
المنية,المنية ,تكميلية المقالع الرسمية - غرفة رقم 2,سني,664,292,5,4,287
المنية,المنية ,تكميلية المقالع الرسمية - غرفة رقم 3,سني,672,305,16,1,289
المنية,المنية ,تكميلية المقالع الرسمية - غرفة رقم 4,سني,640,313,11,2,302
المنية,المنية ,تكميلية المقالع الرسمية - غرفة رقم 5,سني,675,324,17,3,307
المنية,المنية ,تكميلية المقالع الرسمية - غرفة رقم 6,سني,650,332,25,4,307
المنية,المنية ,تكميلية المقالع الرسمية - غرفة رقم 7,سني,673,356,18,4,338
المنية,المنية ,تكميلية المقالع الرسمية - غرفة رقم 8,سني,685,299,13,3,286
المنية,المنية ,ثانوية المنية الرسمية - غرفة رقم 1,روم ارثوذكس,508,181,3,2,178
المنية,المنية ,ثانوية المنية الرسمية - غرفة رقم 2,مسيحي,533,136,4,4,132
المنية,المنية ,ثانوية المنية الرسمية - غرفة رقم 3,روم ارثوذكس,532,177,2,5,175
المنية,المنية ,ثانوية المنية الرسمية - غرفة رقم 4,مسيحي,556,150,1,1,149
المنية,المنية ,ثانوية المنية الرسمية - غرفة رقم 5,سني,725,360,2,2,358
المنية,المنية ,ثانوية المنية الرسمية - غرفة رقم 6,سني,702,389,17,12,372
المنية,المنية ,ثانوية المنية الرسمية - غرفة رقم 7,سني,657,229,1,1,228
المنية,المنية ,ثانوية المنية الرسمية - غرفة رقم 8,سني,702,321,2,0,319
المنية,المنية ,دار البلدية - غرفة رقم 1,سني,683,273,0,1,273
المنية,المنية ,دار البلدية - غرفة رقم 2,سني,653,303,9,1,294
المنية,المنية ,مدرسة المنيه الرسميه المختلطة انجليزي - غرفة رقم 1,سني,687,313,12,7,301
المنية,المنية ,مدرسة المنيه الرسميه المختلطة انجليزي - غرفة رقم 2,سني,690,333,5,0,328
المنية,المنية ,مدرسة المنيه الرسميه المختلطة انجليزي - غرفة رقم 3,سني,669,271,6,0,265
المنية,المنية ,مدرسة المنيه الرسميه المختلطة انجليزي - غرفة رقم 4,سني,714,320,7,4,313
المنية,المنية ,مدرسة المنيه الرسميه المختلطة انجليزي - غرفة رقم 5,سني,686,391,14,3,377
المنية,المنية ,مدرسة المنيه الرسميه المختلطة انجليزي - غرفة رقم 6,سني,726,352,7,4,345
المنية,المنية ,مدرسة المنيه الرسميه المختلطة انجليزي - غرفة رقم 7,سني,694,325,6,4,319
المنية,المنية ,مدرسة النبي كزيبر الرسمية - غرفة رقم 1,سني,667,293,3,6,290
المنية,المنية ,مدرسة النبي كزيبر الرسمية - غرفة رقم 2,سني,673,350,8,7,342
المنية,المنية ,مدرسة النبي كزيبر الرسمية - غرفة رقم 3,سني,703,354,4,2,350
المنية,المنية ,مدرسة النبي كزيبر الرسمية - غرفة رقم 4,سني,693,335,6,1,329
المنية,المنية ,مدرسة النبي كزيبر الرسمية - غرفة رقم 5,سني,696,354,6,4,348
المنية,المنية ,مدرسة النبي كزيبر الرسمية - غرفة رقم 6,سني,661,351,5,5,346
المنية,المنية موظفون ,سراي دير عمار - غرفة رقم 1,مختلف,166,152,5,5,147
المنية,النبي يوشع ,المدرسة الرسمية - غرفة رقم 1,سني,613,379,14,5,365
المنية,النبي يوشع ,المدرسة الرسمية - غرفة رقم 2,سني,618,366,21,0,345
المنية,النبي يوشع ,المدرسة الرسمية - غرفة رقم 3,سني,640,287,6,4,281
المنية,النبي يوشع ,المدرسة الرسمية - غرفة رقم 4,سني,624,327,14,5,313
المنية,النبي يوشع ,المدرسة الرسمية - غرفة رقم 5,سني,603,315,2,0,313
المنية,النبي يوشع ,المدرسة الرسمية - غرفة رقم 6,سني,640,399,15,5,384
المنية,النبي يوشع ,المدرسة الرسمية - غرفة رقم 7,سني,605,344,11,3,333
المنية,النبي يوشع ,المدرسة الرسمية - غرفة رقم 8,سني,603,331,9,4,322
المنية,النبي يوشع ,قاعة جامع الدهيبي - غرفة رقم 1,سني,607,329,12,3,317
المنية,النبي يوشع ,قاعة جامع الدهيبي - غرفة رقم 2,سني,637,361,19,1,342
المنية,النبي يوشع ,قاعة جامع الدهيبي - غرفة رقم 3,سني,639,344,13,8,331
المنية,بحنين ,مدرسة بحنين الرسمية - غرفة رقم 1,سني,675,347,11,2,336
المنية,بحنين ,مدرسة بحنين الرسمية - غرفة رقم 2,سني,688,293,9,7,284
المنية,بحنين ,مدرسة بحنين الرسمية - غرفة رقم 3,سني,662,299,15,6,284
المنية,بحنين ,مدرسة بحنين الرسمية - غرفة رقم 4,سني,692,381,8,5,373
المنية,بحنين ,مدرسة بحنين الرسمية - غرفة رقم 5,سني,670,287,20,3,267
المنية,بحنين ,مدرسة بحنين الرسمية - غرفة رقم 6,سني,649,300,5,1,295
المنية,بحنين ,مدرسة بحنين الرسمية - غرفة رقم 7,سني,638,288,3,3,285
المنية,برج اليهودية ,المدرسة الرسمية - غرفة رقم 1,سني,711,395,13,0,382
المنية,تربل ,المدرسة الرسمية - غرفة رقم 1,روم ارثوذكس,308,125,3,2,122
المنية,دول إقليمية,دول إقليمية,مختلف,965,466,5,1,461
المنية,دير عمار ,مدرسة البيادر الرسمية للبنات - غرفة رقم 1,سني,617,318,1,5,317
المنية,دير عمار ,مدرسة البيادر الرسمية للبنات - غرفة رقم 2,سني,612,312,11,4,301
المنية,دير عمار ,مدرسة البيادر الرسمية للبنات - غرفة رقم 3,سني,620,362,8,3,354
المنية,دير عمار ,مدرسة البيادر الرسمية للبنات - غرفة رقم 4,سني,590,354,7,3,347
المنية,دير عمار ,مدرسة البيادر الرسمية للبنات - غرفة رقم 5,سني,611,291,14,4,277
المنية,دير عمار ,مدرسة الروضة الرسمية في دير عمار - غرفة رقم 1,سني,604,344,15,5,329
المنية,دير عمار ,مدرسة الروضة الرسمية في دير عمار - غرفة رقم 2,سني,611,311,24,2,287
المنية,دير عمار ,مدرسة الروضة الرسمية في دير عمار - غرفة رقم 3,سني,610,352,7,5,345
المنية,دير عمار ,مدرسة الروضة الرسمية في دير عمار - غرفة رقم 4,سني,612,362,15,4,347
المنية,دير عمار ,مدرسة الروضة الرسمية في دير عمار - غرفة رقم 5,سني,583,297,15,3,282
المنية,مركبتا ,المدرسة الرسمية - غرفة رقم 1,روم ارثوذكس,648,239,2,4,237
المنية,مركبتا ,المدرسة الرسمية - غرفة رقم 2,روم ارثوذكس,600,319,4,6,315
النبطية,ارنون ,المدرسة الرسمية - غرفة رقم 1,شيعي,480,265,2,3,263
النبطية,ارنون ,المدرسة الرسمية - غرفة رقم 2,شيعي,491,266,9,0,257
النبطية,ارنون ,المدرسة الرسمية - غرفة رقم 3,شيعي,532,263,1,6,262
النبطية,ارنون ,المدرسة الرسمية - غرفة رقم 4,شيعي,503,284,1,8,283
النبطية,الدوير ,المدرسة الرسمية الابتدائية (حي الوردات) - غرفة رقم 1,شيعي,565,288,2,4,286
النبطية,الدوير ,المدرسة الرسمية الابتدائية (حي الوردات) - غرفة رقم 2,شيعي,563,351,2,3,349
النبطية,الدوير ,المدرسة الرسمية الابتدائية (حي الوردات) - غرفة رقم 3,شيعي,598,362,7,3,355
النبطية,الدوير ,المدرسة الرسمية الابتدائية (حي الوردات) - غرفة رقم 4,شيعي,585,365,4,4,361
النبطية,الدوير ,المدرسة الرسمية الابتدائية (حي الوردات) - غرفة رقم 5,مختلف,607,303,1,3,302
النبطية,الدوير ,ثانوية رمال رمال - غرفة رقم 1,شيعي,587,293,1,2,292
النبطية,الدوير ,ثانوية رمال رمال - غرفة رقم 2,شيعي,574,322,6,5,316
النبطية,الدوير ,ثانوية رمال رمال - غرفة رقم 3,شيعي,574,331,5,7,326
النبطية,الدوير ,ثانوية رمال رمال - غرفة رقم 4,شيعي,547,283,2,5,281
النبطية,الدوير ,ثانوية رمال رمال - غرفة رقم 5,مختلف,560,242,3,4,239
النبطية,الشرقية ,المدرسة الرسمية - غرفة رقم 1,شيعي,552,357,0,0,357
النبطية,الشرقية ,المدرسة الرسمية - غرفة رقم 2,شيعي,614,330,11,4,319
النبطية,الشرقية ,المدرسة الرسمية - غرفة رقم 3,شيعي,605,420,5,0,415
النبطية,الشرقية ,المدرسة الرسمية - غرفة رقم 4,شيعي,538,322,7,3,315
النبطية,القصيبه ,المدرسة الرسمية - غرفة رقم 1,شيعي,654,404,14,1,390
النبطية,القصيبه ,المدرسة الرسمية - غرفة رقم 2,شيعي,654,386,6,0,380
النبطية,القصيبه ,المدرسة الرسمية - غرفة رقم 3,شيعي,633,443,1,1,442
النبطية,القصيبه ,المدرسة الرسمية - غرفة رقم 4,شيعي,623,437,2,0,435
النبطية,القصيبه ,المدرسة الرسمية - غرفة رقم 5,شيعي,580,363,10,4,353
النبطية,الكفور ,مدرسة الكفور الرسمية - غرفة رقم 1,شيعي,566,292,4,0,288
النبطية,الكفور ,مدرسة الكفور الرسمية - غرفة رقم 2,شيعي,571,318,6,2,312
النبطية,الكفور ,مدرسة الكفور الرسمية - غرفة رقم 3,مختلف,538,158,4,2,154
النبطية,الكفور ,مدرسة الكفور الرسمية - غرفة رقم 4,مختلف,536,157,1,1,156
النبطية,النبطية التحتا حي البياض ,المدرسة المهنية الرسمية - غرفة رقم 1,شيعي,610,198,5,2,193
النبطية,النبطية التحتا حي البياض ,المدرسة المهنية الرسمية - غرفة رقم 10,شيعي,615,263,4,2,259
النبطية,النبطية التحتا حي البياض ,المدرسة المهنية الرسمية - غرفة رقم 11,شيعي,619,276,5,0,271
النبطية,النبطية التحتا حي البياض ,المدرسة المهنية الرسمية - غرفة رقم 12,شيعي,627,302,3,1,299
النبطية,النبطية التحتا حي البياض ,المدرسة المهنية الرسمية - غرفة رقم 13,مختلف,614,240,6,1,234
النبطية,النبطية التحتا حي البياض ,المدرسة المهنية الرسمية - غرفة رقم 2,شيعي,618,179,4,1,175
النبطية,النبطية التحتا حي البياض ,المدرسة المهنية الرسمية - غرفة رقم 3,شيعي,637,280,4,6,276
النبطية,النبطية التحتا حي البياض ,المدرسة المهنية الرسمية - غرفة رقم 4,شيعي,613,222,2,0,220
النبطية,النبطية التحتا حي البياض ,المدرسة المهنية الرسمية - غرفة رقم 5,شيعي,623,279,5,5,274
النبطية,النبطية التحتا حي البياض ,المدرسة المهنية الرسمية - غرفة رقم 6,شيعي,640,302,7,2,295
النبطية,النبطية التحتا حي البياض ,المدرسة المهنية الرسمية - غرفة رقم 7,شيعي,613,216,6,0,210
النبطية,النبطية التحتا حي البياض ,المدرسة المهنية الرسمية - غرفة رقم 8,شيعي,608,199,2,0,197
النبطية,النبطية التحتا حي البياض ,المدرسة المهنية الرسمية - غرفة رقم 9,شيعي,593,284,3,1,281
النبطية,النبطية التحتا حي السراي ,تجمع المدارس الجديدة في النبطية - غرفة رقم 1,شيعي,604,305,3,1,302
النبطية,النبطية التحتا حي السراي ,تجمع المدارس الجديدة في النبطية - غرفة رقم 10,شيعي,606,265,0,2,265
النبطية,النبطية التحتا حي السراي ,تجمع المدارس الجديدة في النبطية - غرفة رقم 11,شيعي,620,326,9,4,317
النبطية,النبطية التحتا حي السراي ,تجمع المدارس الجديدة في النبطية - غرفة رقم 12,شيعي,602,282,1,2,281
النبطية,النبطية التحتا حي السراي ,تجمع المدارس الجديدة في النبطية - غرفة رقم 13,شيعي,617,295,1,2,294
النبطية,النبطية التحتا حي السراي ,تجمع المدارس الجديدة في النبطية - غرفة رقم 14,شيعي,601,321,3,1,318
النبطية,النبطية التحتا حي السراي ,تجمع المدارس الجديدة في النبطية - غرفة رقم 15,شيعي,602,279,3,1,276
النبطية,النبطية التحتا حي السراي ,تجمع المدارس الجديدة في النبطية - غرفة رقم 16,شيعي,624,285,4,2,281
النبطية,النبطية التحتا حي السراي ,تجمع المدارس الجديدة في النبطية - غرفة رقم 2,شيعي,606,252,12,5,240
النبطية,النبطية التحتا حي السراي ,تجمع المدارس الجديدة في النبطية - غرفة رقم 3,شيعي,593,290,3,3,287
النبطية,النبطية التحتا حي السراي ,تجمع المدارس الجديدة في النبطية - غرفة رقم 4,شيعي,616,272,4,3,268
النبطية,النبطية التحتا حي السراي ,تجمع المدارس الجديدة في النبطية - غرفة رقم 5,شيعي,563,270,6,2,264
النبطية,النبطية التحتا حي السراي ,تجمع المدارس الجديدة في النبطية - غرفة رقم 6,شيعي,575,266,1,0,265
النبطية,النبطية التحتا حي السراي ,تجمع المدارس الجديدة في النبطية - غرفة رقم 7,شيعي,579,256,2,1,254
النبطية,النبطية التحتا حي السراي ,تجمع المدارس الجديدة في النبطية - غرفة رقم 8,مختلف,585,270,1,4,269
النبطية,النبطية التحتا حي السراي ,تجمع المدارس الجديدة في النبطية - غرفة رقم 9,شيعي,610,309,1,1,308
النبطية,النبطية التحتا حي المسيحيين ,ثانوية الصباح الرسمية القديمة ( مدرسة عبد اللطيف فياض) - غرفة رقم 1,مختلف,479,70,1,0,69
النبطية,النبطية التحتا حي الميدان ,ثانوية الصباح الرسمية القديمة ( مدرسة عبد اللطيف فياض) - غرفة رقم 2,شيعي,651,307,5,5,302
النبطية,النبطية التحتا حي الميدان ,ثانوية الصباح الرسمية القديمة ( مدرسة عبد اللطيف فياض) - غرفة رقم 3,شيعي,615,209,0,0,209
النبطية,النبطية التحتا حي الميدان ,ثانوية الصباح الرسمية القديمة ( مدرسة عبد اللطيف فياض) - غرفة رقم 4,شيعي,626,260,5,0,255
النبطية,النبطية التحتا حي الميدان ,ثانوية الصباح الرسمية القديمة ( مدرسة عبد اللطيف فياض) - غرفة رقم 5,شيعي,634,330,6,3,324
النبطية,النبطية التحتا حي الميدان ,ثانوية الصباح الرسمية القديمة ( مدرسة عبد اللطيف فياض) - غرفة رقم 6,شيعي,591,207,0,0,207
النبطية,النبطية التحتا حي الميدان ,ثانوية الصباح الرسمية القديمة ( مدرسة عبد اللطيف فياض) - غرفة رقم 7,شيعي,626,264,1,0,263
النبطية,النبطية التحتا حي الميدان ,ثانوية الصباح الرسمية القديمة ( مدرسة عبد اللطيف فياض) - غرفة رقم 8,مختلف,630,274,5,2,269
النبطية,النبطية الفوقا ,المدرسة الرسمية - غرفة رقم 1,شيعي,599,317,2,5,315
النبطية,النبطية الفوقا ,المدرسة الرسمية - غرفة رقم 2,شيعي,650,350,4,2,346
النبطية,النبطية الفوقا ,المدرسة الرسمية - غرفة رقم 3,شيعي,600,284,0,2,284
النبطية,النبطية الفوقا ,المدرسة الرسمية - غرفة رقم 4,مختلف,633,292,2,4,290
النبطية,النبطية الفوقا ,المدرسة الرسمية - غرفة رقم 5,شيعي,606,335,4,3,331
النبطية,النبطية الفوقا ,المدرسة الرسمية - غرفة رقم 6,شيعي,605,365,3,2,362
النبطية,النبطية الفوقا ,المدرسة الرسمية - غرفة رقم 7,شيعي,595,296,0,1,296
النبطية,النبطية الفوقا ,المدرسة الرسمية - غرفة رقم 8,مختلف,606,295,4,3,291
النبطية,النبطية موظفون ,سراي النبطية - غرفة رقم 1,مختلف,498,498,9,21,489
النبطية,النبطية موظفون ,سراي النبطية - غرفة رقم 2,مختلف,550,481,11,12,470
النبطية,النميريه ,الحسينية - غرفة رقم 1,شيعي,569,307,6,0,301
النبطية,النميريه ,الحسينية - غرفة رقم 2,شيعي,571,289,0,1,289
النبطية,النميريه ,الحسينية - غرفة رقم 3,شيعي,562,290,9,1,281
النبطية,النميريه ,الحسينية - غرفة رقم 4,شيعي,567,329,1,3,328
النبطية,النميريه ,الحسينية - غرفة رقم 5,شيعي,582,326,9,3,317
النبطية,النميريه ,الحسينية - غرفة رقم 6,شيعي,597,322,1,2,321
النبطية,انصار ,ثانوية انصار الرسمية - غرفة رقم 1,شيعي,632,342,1,3,341
النبطية,انصار ,ثانوية انصار الرسمية - غرفة رقم 2,شيعي,637,340,1,8,339
النبطية,انصار ,ثانوية انصار الرسمية - غرفة رقم 3,شيعي,634,369,5,4,364
النبطية,انصار ,ثانوية انصار الرسمية - غرفة رقم 4,شيعي,660,363,3,9,360
النبطية,انصار ,ثانوية انصار الرسمية - غرفة رقم 5,مختلف,649,385,0,1,385
النبطية,انصار ,مدرسة انصار المتوسطة (حاليا الابتدائية) - غرفة رقم 1,شيعي,611,292,6,1,286
النبطية,انصار ,مدرسة انصار المتوسطة (حاليا الابتدائية) - غرفة رقم 2,شيعي,653,310,3,2,307
النبطية,انصار ,مدرسة انصار المتوسطة (حاليا الابتدائية) - غرفة رقم 3,شيعي,657,340,6,6,334
النبطية,انصار ,مدرسة انصار المتوسطة (حاليا الابتدائية) - غرفة رقم 4,شيعي,634,333,4,6,329
النبطية,انصار ,مدرسة انصار المتوسطة (حاليا الابتدائية) - غرفة رقم 5,شيعي,609,341,3,5,338
النبطية,بريقع ,مدرسة بريقع الرسمية - غرفة رقم 1,شيعي,546,259,1,3,258
النبطية,بريقع ,مدرسة بريقع الرسمية - غرفة رقم 2,شيعي,540,312,2,6,310
النبطية,بريقع ,مدرسة بريقع الرسمية - غرفة رقم 3,شيعي,535,327,5,3,322
النبطية,تول ,مدرسة الكفور - غرفة رقم 5,مختلف,27,13,0,0,13
النبطية,جباع ,المدرسة الرسمية الابتدائية - غرفة رقم 1,شيعي,595,330,5,4,325
النبطية,جباع ,المدرسة الرسمية الابتدائية - غرفة رقم 2,شيعي,619,309,1,8,308
النبطية,جباع ,المدرسة الرسمية الابتدائية - غرفة رقم 3,شيعي,611,337,9,11,328
النبطية,جباع ,المدرسة الرسمية الابتدائية - غرفة رقم 4,شيعي,608,316,5,3,311
النبطية,جباع ,المدرسة الرسمية الابتدائية - غرفة رقم 5,شيعي,593,297,5,3,292
النبطية,جباع ,المدرسة الرسمية الابتدائية - غرفة رقم 6,شيعي,610,359,5,5,354
النبطية,جباع ,المدرسة الرسمية الابتدائية - غرفة رقم 7,مختلف,545,284,8,6,276
النبطية,جبشيت ,مدرسة جبشيت المتوسطة - غرفة رقم 1,شيعي,626,389,1,9,388
النبطية,جبشيت ,مدرسة جبشيت المتوسطة - غرفة رقم 10,شيعي,625,375,2,3,373
النبطية,جبشيت ,مدرسة جبشيت المتوسطة - غرفة رقم 11,شيعي,596,351,10,3,341
النبطية,جبشيت ,مدرسة جبشيت المتوسطة - غرفة رقم 2,شيعي,603,410,3,0,407
النبطية,جبشيت ,مدرسة جبشيت المتوسطة - غرفة رقم 3,شيعي,617,377,4,6,373
النبطية,جبشيت ,مدرسة جبشيت المتوسطة - غرفة رقم 4,شيعي,614,410,7,1,403
النبطية,جبشيت ,مدرسة جبشيت المتوسطة - غرفة رقم 5,شيعي,610,372,9,2,363
النبطية,جبشيت ,مدرسة جبشيت المتوسطة - غرفة رقم 6,شيعي,636,401,1,5,400
النبطية,جبشيت ,مدرسة جبشيت المتوسطة - غرفة رقم 7,شيعي,620,432,2,0,430
النبطية,جبشيت ,مدرسة جبشيت المتوسطة - غرفة رقم 8,شيعي,640,409,1,2,408
النبطية,جبشيت ,مدرسة جبشيت المتوسطة - غرفة رقم 9,شيعي,593,409,5,6,404
النبطية,جرجوع ,المدرسة الجديدة - غرفة رقم 1,شيعي,529,287,3,6,284
النبطية,جرجوع ,المدرسة الجديدة - غرفة رقم 2,مختلف,577,261,6,4,255
النبطية,جرجوع ,المدرسة الجديدة - غرفة رقم 3,شيعي,523,256,2,6,254
النبطية,جرجوع ,المدرسة الجديدة - غرفة رقم 4,شيعي,525,275,2,5,273
النبطية,جرجوع ,المدرسة الجديدة - غرفة رقم 5,مختلف,516,157,3,5,154
النبطية,حاروف ,ثانوية الشهيدين في بلدة حاروف - غرفة رقم 1,شيعي,658,381,11,1,370
النبطية,حاروف ,ثانوية الشهيدين في بلدة حاروف - غرفة رقم 2,شيعي,647,375,5,3,370
النبطية,حاروف ,ثانوية الشهيدين في بلدة حاروف - غرفة رقم 3,شيعي,645,392,6,4,386
النبطية,حاروف ,ثانوية الشهيدين في بلدة حاروف - غرفة رقم 4,شيعي,653,342,9,2,333
النبطية,حاروف ,ثانوية الشهيدين في بلدة حاروف - غرفة رقم 5,شيعي,608,366,1,1,365
النبطية,حاروف ,ثانوية الشهيدين في بلدة حاروف - غرفة رقم 6,شيعي,644,402,4,3,398
النبطية,حاروف ,ثانوية الشهيدين في بلدة حاروف - غرفة رقم 7,شيعي,630,393,4,0,389
النبطية,حاروف ,ثانوية الشهيدين في بلدة حاروف - غرفة رقم 8,شيعي,658,378,1,2,377
النبطية,حاروف ,ثانوية الشهيدين في بلدة حاروف - غرفة رقم 9,شيعي,627,419,4,0,415
النبطية,حبوش ,المدرسة المتوسطة للصبيان - غرفة رقم 1,شيعي,606,307,5,2,302
النبطية,حبوش ,المدرسة المتوسطة للصبيان - غرفة رقم 10,مختلف,572,286,10,0,276
النبطية,حبوش ,المدرسة المتوسطة للصبيان - غرفة رقم 2,شيعي,584,287,3,7,284
النبطية,حبوش ,المدرسة المتوسطة للصبيان - غرفة رقم 3,شيعي,619,316,10,8,306
النبطية,حبوش ,المدرسة المتوسطة للصبيان - غرفة رقم 4,شيعي,614,289,1,2,288
النبطية,حبوش ,المدرسة المتوسطة للصبيان - غرفة رقم 5,شيعي,629,292,4,4,288
النبطية,حبوش ,المدرسة المتوسطة للصبيان - غرفة رقم 6,شيعي,599,319,2,3,317
النبطية,حبوش ,المدرسة المتوسطة للصبيان - غرفة رقم 7,شيعي,628,341,3,6,338
النبطية,حبوش ,المدرسة المتوسطة للصبيان - غرفة رقم 8,شيعي,619,327,4,2,323
النبطية,حبوش ,المدرسة المتوسطة للصبيان - غرفة رقم 9,شيعي,585,283,1,1,282
النبطية,حومين التحتا ,مدرسة حومين التحتا - غرفة رقم 1,شيعي,578,315,9,3,306
النبطية,حومين التحتا ,مدرسة حومين التحتا - غرفة رقم 2,شيعي,549,275,1,2,274
النبطية,حومين التحتا ,مدرسة حومين التحتا - غرفة رقم 3,شيعي,548,291,4,0,287
النبطية,حومين التحتا ,مدرسة حومين التحتا - غرفة رقم 4,شيعي,570,317,5,2,312
النبطية,حومين الفوقا ,المدرسة الابتدائية الرسمية - غرفة رقم 1,شيعي,559,353,5,4,348
النبطية,حومين الفوقا ,المدرسة الابتدائية الرسمية - غرفة رقم 2,شيعي,563,355,1,3,354
النبطية,حومين الفوقا ,المدرسة الابتدائية الرسمية - غرفة رقم 3,شيعي,564,404,1,8,403
النبطية,حومين الفوقا ,المدرسة الابتدائية الرسمية - غرفة رقم 4,شيعي,560,384,1,6,383
النبطية,حومين الفوقا ,المدرسة الابتدائية الرسمية - غرفة رقم 5,شيعي,548,374,2,6,372
النبطية,دول إقليمية,دول إقليمية,مختلف,2105,1143,144,12,999
النبطية,دير الزهراني ,مدرسة دير الزهراني الرسمية - غرفة رقم 1,شيعي,599,334,7,5,327
النبطية,دير الزهراني ,مدرسة دير الزهراني الرسمية - غرفة رقم 2,شيعي,619,371,3,3,368
النبطية,دير الزهراني ,مدرسة دير الزهراني الرسمية - غرفة رقم 3,مختلف,582,255,9,1,246
النبطية,دير الزهراني ,مدرسة دير الزهراني الرسمية - غرفة رقم 4,شيعي,618,361,9,3,352
النبطية,دير الزهراني ,مدرسة دير الزهراني الرسمية - غرفة رقم 5,شيعي,596,357,8,2,349
النبطية,دير الزهراني ,مدرسة دير الزهراني الرسمية - غرفة رقم 6,مختلف,574,266,1,0,265
النبطية,رومين ,المدرسة الرسمية - غرفة رقم 1,شيعي,520,289,3,7,286
النبطية,رومين ,المدرسة الرسمية - غرفة رقم 2,شيعي,518,337,6,9,331
النبطية,رومين ,المدرسة الرسمية - غرفة رقم 3,شيعي,501,296,8,4,288
النبطية,زبدين ,مدرسة زبدين الرسمية - غرفة رقم 1,شيعي,496,284,1,0,283
النبطية,زبدين ,مدرسة زبدين الرسمية - غرفة رقم 2,شيعي,464,271,4,6,267
النبطية,زبدين ,مدرسة زبدين الرسمية - غرفة رقم 3,شيعي,508,294,1,2,293
النبطية,زبدين ,مدرسة زبدين الرسمية - غرفة رقم 4,شيعي,520,323,1,9,322
النبطية,زفتا ,المدرسة الرسمية - غرفة رقم 1,شيعي,529,302,10,8,292
النبطية,زفتا ,المدرسة الرسمية - غرفة رقم 2,شيعي,501,285,3,0,282
النبطية,زفتا ,المدرسة الرسمية - غرفة رقم 3,شيعي,494,262,1,3,261
النبطية,زفتا ,المدرسة الرسمية - غرفة رقم 4,شيعي,533,305,6,0,299
النبطية,زوطر الشرقية ,المدرسة الرسمية - غرفة رقم 1,شيعي,553,306,4,4,302
النبطية,زوطر الشرقية ,المدرسة الرسمية - غرفة رقم 2,شيعي,540,308,2,5,306
النبطية,زوطر الشرقية ,المدرسة الرسمية - غرفة رقم 3,شيعي,527,349,1,3,348
النبطية,زوطر الشرقية ,المدرسة الرسمية - غرفة رقم 4,شيعي,525,341,3,3,338
النبطية,زوطر الغربية ,المدرسة الرسمية - غرفة رقم 1,شيعي,488,264,5,11,259
النبطية,زوطر الغربية ,المدرسة الرسمية - غرفة رقم 2,شيعي,469,286,6,15,280
النبطية,زوطر الغربية ,المدرسة الرسمية - غرفة رقم 3,شيعي,476,242,5,1,237
النبطية,سيني ,المدرسة الرسمية - غرفة رقم 1,شيعي,387,246,1,1,245
النبطية,سيني ,المدرسة الرسمية - غرفة رقم 2,شيعي,360,239,1,1,238
النبطية,شوكين ,المدرسة الرسمية - غرفة رقم 1,شيعي,529,271,4,1,267
النبطية,شوكين ,المدرسة الرسمية - غرفة رقم 2,شيعي,541,262,4,3,258
النبطية,صربا ,صالة الكنيسة - غرفة رقم 1,ماروني,613,234,2,0,232
النبطية,صربا ,صالة الكنيسة - غرفة رقم 2,ماروني,610,226,0,2,226
النبطية,صربا ,صالة الكنيسة - غرفة رقم 3,مختلف,586,186,2,1,184
النبطية,صير الغربية ,المدرسة الرسمية - غرفة رقم 1,شيعي,589,342,6,0,336
النبطية,صير الغربية ,المدرسة الرسمية - غرفة رقم 2,شيعي,582,352,3,1,349
النبطية,صير الغربية ,المدرسة الرسمية - غرفة رقم 3,شيعي,588,361,6,1,355
النبطية,صير الغربية ,المدرسة الرسمية - غرفة رقم 4,شيعي,590,414,1,1,413
النبطية,صير الغربية ,المدرسة الرسمية - غرفة رقم 5,شيعي,611,330,3,0,327
النبطية,عبا ,المدرسة الرسمية المتوسطة - غرفة رقم 1,شيعي,626,338,0,4,338
النبطية,عبا ,المدرسة الرسمية المتوسطة - غرفة رقم 2,شيعي,661,372,3,5,369
النبطية,عبا ,المدرسة الرسمية المتوسطة - غرفة رقم 3,شيعي,637,338,3,1,335
النبطية,عبا ,المدرسة الرسمية المتوسطة - غرفة رقم 4,شيعي,633,370,8,4,362
النبطية,عبا ,المدرسة الرسمية المتوسطة - غرفة رقم 5,شيعي,623,382,0,0,382
النبطية,عبا ,المدرسة الرسمية المتوسطة - غرفة رقم 6,شيعي,605,359,2,2,357
النبطية,عبا ,المدرسة الرسمية المتوسطة - غرفة رقم 7,شيعي,610,333,2,1,331
النبطية,عدشيت ,المدرسة الرسمية - غرفة رقم 1,شيعي,641,432,3,2,429
النبطية,عدشيت ,المدرسة الرسمية - غرفة رقم 2,شيعي,623,435,5,1,430
النبطية,عدشيت ,المدرسة الرسمية - غرفة رقم 3,شيعي,580,406,4,0,402
النبطية,عدشيت ,المدرسة الرسمية - غرفة رقم 4,شيعي,611,440,3,1,437
النبطية,عدشيت ,المدرسة الرسمية - غرفة رقم 5,شيعي,587,372,8,3,364
النبطية,عرب صاليم ,المدرسة الرسمية - غرفة رقم 1,شيعي,648,356,1,4,355
النبطية,عرب صاليم ,المدرسة الرسمية - غرفة رقم 2,شيعي,595,340,4,3,336
النبطية,عرب صاليم ,المدرسة الرسمية - غرفة رقم 3,شيعي,594,391,5,3,386
النبطية,عرب صاليم ,المدرسة الرسمية - غرفة رقم 4,شيعي,581,358,3,3,355
النبطية,عرب صاليم ,المدرسة الرسمية - غرفة رقم 5,شيعي,622,363,6,5,357
النبطية,عرب صاليم ,المدرسة الرسمية - غرفة رقم 6,شيعي,611,361,0,1,361
النبطية,عرب صاليم ,المدرسة الرسمية - غرفة رقم 7,شيعي,623,389,0,2,389
النبطية,عرب صاليم ,المدرسة الرسمية - غرفة رقم 8,شيعي,574,360,0,0,360
النبطية,عزه ,مدرسة عزه القديمة - غرفة رقم 1,مختلف,532,217,6,2,211
النبطية,عزه ,مدرسة عزه القديمة - غرفة رقم 2,مختلف,550,212,4,5,208
النبطية,عين بوسوار ,مدرسة زهير شحاده الرسمية - غرفة رقم 1,شيعي,466,296,7,2,289
النبطية,عين بوسوار ,مدرسة زهير شحاده الرسمية - غرفة رقم 2,شيعي,459,293,2,1,291
النبطية,عين قانا ,مدرسة عين قانا الرسمية الابتدائية - غرفة رقم 1,شيعي,663,369,2,2,367
النبطية,عين قانا ,مدرسة عين قانا الرسمية الابتدائية - غرفة رقم 2,شيعي,668,376,3,1,373
النبطية,عين قانا ,مدرسة عين قانا الرسمية الابتدائية - غرفة رقم 3,شيعي,625,376,0,2,376
النبطية,عين قانا ,مدرسة عين قانا الرسمية الابتدائية - غرفة رقم 4,شيعي,653,376,0,0,376
النبطية,عين قانا ,مدرسة عين قانا الرسمية الابتدائية - غرفة رقم 5,شيعي,644,373,4,4,369
النبطية,قعقعية الجسر ,المدرسة الرسمية الجديدة - غرفة رقم 1,شيعي,592,296,2,5,294
النبطية,قعقعية الجسر ,المدرسة الرسمية الجديدة - غرفة رقم 2,شيعي,593,294,4,4,290
النبطية,قعقعية الجسر ,المدرسة الرسمية الجديدة - غرفة رقم 3,شيعي,603,300,3,2,297
النبطية,قعقعية الجسر ,المدرسة الرسمية الجديدة - غرفة رقم 4,شيعي,592,368,0,1,368
النبطية,قعقعية الجسر ,المدرسة الرسمية الجديدة - غرفة رقم 5,شيعي,588,365,5,6,360
النبطية,قعقعية الجسر ,المدرسة الرسمية الجديدة - غرفة رقم 6,مختلف,577,344,2,3,342
النبطية,كفر تبنيت ,مدرسة كفرتبنيت الرسمية - غرفة رقم 1,شيعي,589,264,6,2,258
النبطية,كفر تبنيت ,مدرسة كفرتبنيت الرسمية - غرفة رقم 2,شيعي,609,277,1,3,276
النبطية,كفر تبنيت ,مدرسة كفرتبنيت الرسمية - غرفة رقم 3,شيعي,606,290,7,6,283
النبطية,كفر تبنيت ,مدرسة كفرتبنيت الرسمية - غرفة رقم 4,شيعي,585,251,2,8,249
النبطية,كفر تبنيت ,مدرسة كفرتبنيت الرسمية - غرفة رقم 5,شيعي,572,322,14,6,308
النبطية,كفر تبنيت ,مدرسة كفرتبنيت الرسمية - غرفة رقم 6,شيعي,580,282,2,3,280
النبطية,كفر تبنيت ,مدرسة كفرتبنيت الرسمية - غرفة رقم 7,شيعي,578,347,3,3,344
النبطية,كفر تبنيت ,مدرسة كفرتبنيت الرسمية - غرفة رقم 8,سني,592,265,1,6,264
النبطية,كفر رمان ,المدرسة المتوسطة - غرفة رقم 1,شيعي,598,318,7,0,311
النبطية,كفر رمان ,المدرسة المتوسطة - غرفة رقم 2,شيعي,636,368,8,10,360
النبطية,كفر رمان ,المدرسة المتوسطة - غرفة رقم 3,شيعي,587,361,11,4,350
النبطية,كفر رمان ,المدرسة المتوسطة - غرفة رقم 4,شيعي,580,330,7,6,323
النبطية,كفر رمان ,المدرسة المتوسطة - غرفة رقم 5,شيعي,597,289,8,1,281
النبطية,كفر رمان ,ثانوية كفررمان - غرفة رقم 1,شيعي,580,364,14,4,350
النبطية,كفر رمان ,ثانوية كفررمان - غرفة رقم 2,شيعي,638,390,4,7,386
النبطية,كفر رمان ,ثانوية كفررمان - غرفة رقم 3,شيعي,625,394,3,7,391
النبطية,كفر رمان ,ثانوية كفررمان - غرفة رقم 4,شيعي,589,369,8,2,361
النبطية,كفر رمان ,ثانوية كفررمان - غرفة رقم 5,شيعي,604,336,4,2,332
النبطية,كفرصير ,المدرسة الرسمية - غرفة رقم 1,شيعي,605,344,1,0,343
النبطية,كفرصير ,المدرسة الرسمية - غرفة رقم 2,شيعي,586,362,4,2,358
النبطية,كفرصير ,المدرسة الرسمية - غرفة رقم 3,شيعي,592,350,0,3,350
النبطية,كفرصير ,المدرسة الرسمية - غرفة رقم 4,شيعي,585,386,2,3,384
النبطية,كفرصير ,المدرسة الرسمية - غرفة رقم 5,شيعي,580,415,9,1,406
النبطية,كفرصير ,المدرسة الرسمية - غرفة رقم 6,شيعي,549,347,3,0,344
النبطية,كفرصير ,المدرسة الرسمية - غرفة رقم 7,شيعي,602,404,13,1,391
النبطية,كفرفيلا ,المدرسة الرسمية الابتدائية - غرفة رقم 1,شيعي,499,313,8,3,305
النبطية,كفرفيلا ,المدرسة الرسمية الابتدائية - غرفة رقم 2,شيعي,519,317,2,1,315
النبطية,كفرفيلا ,المدرسة الرسمية الابتدائية - غرفة رقم 3,شيعي,482,263,0,0,263
النبطية,كفروة ,كنيسة مار يوسف - غرفة رقم 1,مختلف,368,137,0,2,137
النبطية,كفروة ,كنيسة مار يوسف - غرفة رقم 2,مختلف,350,119,2,0,117
النبطية,ميفدون ,المدرسة الرسمية - غرفة رقم 1,شيعي,641,357,5,3,352
النبطية,ميفدون ,المدرسة الرسمية - غرفة رقم 2,شيعي,588,294,6,0,288
النبطية,ميفدون ,المدرسة الرسمية - غرفة رقم 3,شيعي,596,322,1,4,321
النبطية,ميفدون ,المدرسة الرسمية - غرفة رقم 4,شيعي,607,283,1,0,282
النبطية,ميفدون ,المدرسة الرسمية - غرفة رقم 5,شيعي,602,296,8,2,288
النبطية,يحمر ,المدرسة الرسمية - غرفة رقم 1,شيعي,662,376,3,3,373
النبطية,يحمر ,المدرسة الرسمية - غرفة رقم 2,شيعي,587,270,4,1,266
النبطية,يحمر ,المدرسة الرسمية - غرفة رقم 3,شيعي,576,361,6,3,355
النبطية,يحمر ,المدرسة الرسمية - غرفة رقم 4,شيعي,588,342,4,8,338
الهرمل,البستان ,المدرسة الرسمية - غرفة رقم 1,شيعي,363,227,5,5,222
الهرمل,البستان ,المدرسة الرسمية - غرفة رقم 2,مسلم,385,274,4,1,270
الهرمل,البويضة ,المدرسة الرسمية - غرفة رقم 1,شيعي,424,339,0,2,339
الهرمل,البويضة الحي الغربي ,المدرسة الرسمية - غرفة رقم 3,شيعي,74,66,1,0,65
الهرمل,البويضة الشمالية ,المدرسة الرسمية - غرفة رقم 2,شيعي,177,111,0,0,111
الهرمل,الحريقه ,المدرسة الرسمية - غرفة رقم 1,شيعي,585,433,4,0,429
الهرمل,الخرايب ,المدرسة الرسمية في الخرايب - غرفة رقم 1,مسلم,446,293,7,1,286
الهرمل,الزغرين ,مدرسة زغرين الفوقا - غرفة رقم 1,شيعي,593,360,5,3,355
الهرمل,الزغرين ,مدرسة زغرين الفوقا - غرفة رقم 2,شيعي,602,365,2,1,363
الهرمل,الزغرين ,مدرسة زغرين الفوقا - غرفة رقم 3,شيعي,613,303,5,1,298
الهرمل,الزويتيني ,المدرسة الرسمية - غرفة رقم 1,شيعي,332,204,4,3,200
الهرمل,الزويتيني ,المدرسة الرسمية - غرفة رقم 2,شيعي,369,211,2,0,209
الهرمل,السويسة ,مدرسة فيسان الرسمية - غرفة رقم 1,شيعي,504,331,3,0,328
الهرمل,الشربين ,المدرسة الرسمية - غرفة رقم 1,شيعي,576,403,2,2,401
الهرمل,الشربين ,المدرسة الرسمية - غرفة رقم 2,مختلف,553,304,4,1,300
الهرمل,الشربين ,المدرسة الرسمية - غرفة رقم 3,شيعي,628,460,2,1,458
الهرمل,الشربين ,المدرسة الرسمية - غرفة رقم 4,مختلف,628,389,5,0,384
الهرمل,الشواغير التحتا ,المدرسة الرسمية - غرفة رقم 1,شيعي,569,341,7,2,334
الهرمل,الشواغير التحتا ,المدرسة الرسمية - غرفة رقم 2,شيعي,627,406,8,0,398
الهرمل,الشواغير التحتا ,المدرسة الرسمية - غرفة رقم 3,مختلف,443,225,2,0,223
الهرمل,الشواغير التحتا ,المدرسة الرسمية - غرفة رقم 4,مختلف,446,137,9,4,128
الهرمل,الشواغير الفوقا ,دار المعلمين والمعلمات - غرفة رقم 1,شيعي,643,400,15,3,385
الهرمل,القرينة ,مدرسة الشواغير الرسمية - غرفة رقم 5,شيعي,76,55,0,0,55
الهرمل,القصر ,المدرسة الرسمية - غرفة رقم 1,شيعي,643,383,3,0,380
الهرمل,القصر ,المدرسة الرسمية - غرفة رقم 2,شيعي,684,434,1,3,433
الهرمل,القصر ,المدرسة الرسمية - غرفة رقم 3,شيعي,670,417,13,1,404
الهرمل,القصر ,المدرسة الرسمية - غرفة رقم 4,شيعي,661,399,3,0,396
الهرمل,القصر ,المدرسة الرسمية - غرفة رقم 5,شيعي,675,412,0,1,412
الهرمل,القصر ,مدرسة القصر الفنية (المهنية) - غرفة رقم 1,مختلف,744,347,9,2,338
الهرمل,القصر ,مدرسة القصر الفنية (المهنية) - غرفة رقم 2,شيعي,653,413,11,0,402
الهرمل,القصر ,مدرسة القصر الفنية (المهنية) - غرفة رقم 3,شيعي,696,447,9,2,438
الهرمل,القصر ,مدرسة القصر الفنية (المهنية) - غرفة رقم 4,شيعي,690,409,7,1,402
الهرمل,القصر ,مدرسة القصر الفنية (المهنية) - غرفة رقم 5,شيعي,664,379,6,0,373
الهرمل,القصر ,مدرسة القصر الفنية (المهنية) - غرفة رقم 6,شيعي,682,382,19,2,363
الهرمل,القصر ,مدرسة القصر الفنية (المهنية) - غرفة رقم 7,مختلف,709,363,18,3,345
الهرمل,الكواخ ,المدرسة الرسمية - غرفة رقم 1,شيعي,509,344,3,0,341
الهرمل,الكواخ ,المدرسة الرسمية - غرفة رقم 2,شيعي,480,319,5,1,314
الهرمل,الكواخ ,المدرسة الرسمية - غرفة رقم 3,شيعي,517,359,2,1,357
الهرمل,الكواخ ,المدرسة الرسمية - غرفة رقم 4,شيعي,495,327,0,0,327
الهرمل,المعاصر ,ثانوية الهرمل النموذجية - غرفة رقم 6,شيعي,274,195,2,0,193
الهرمل,المعيصرة ,ثانوية الهرمل النموذجية - غرفة رقم 7,مسلم,131,64,0,0,64
الهرمل,الهرمل حي الحارة ,ثانوية الهرمل الرسمية - غرفة رقم 1,شيعي,628,370,3,3,367
الهرمل,الهرمل حي الحارة ,ثانوية الهرمل الرسمية - غرفة رقم 2,شيعي,635,365,1,1,364
الهرمل,الهرمل حي الحارة ,ثانوية الهرمل الرسمية - غرفة رقم 3,شيعي,633,372,15,1,357
الهرمل,الهرمل حي الحارة ,ثانوية الهرمل الرسمية - غرفة رقم 4,شيعي,634,414,5,1,409
الهرمل,الهرمل حي الحارة ,ثانوية الهرمل الرسمية - غرفة رقم 5,شيعي,642,379,5,3,374
الهرمل,الهرمل حي الحارة ,ثانوية الهرمل الرسمية - غرفة رقم 6,شيعي,636,377,6,1,371
الهرمل,الهرمل حي الحارة ,ثانوية الهرمل الرسمية - غرفة رقم 7,مسلم,638,371,1,1,370
الهرمل,الهرمل حي الحارة ,مدرسة الهرمل الفنية العالية - غرفة رقم 1,شيعي,635,392,8,0,384
الهرمل,الهرمل حي الحارة ,مدرسة الهرمل الفنية العالية - غرفة رقم 2,شيعي,640,354,4,0,350
الهرمل,الهرمل حي الحارة ,مدرسة الهرمل الفنية العالية - غرفة رقم 3,شيعي,628,380,10,1,370
الهرمل,الهرمل حي الحارة ,مدرسة الهرمل الفنية العالية - غرفة رقم 4,شيعي,648,423,5,0,418
الهرمل,الهرمل حي الحارة ,مدرسة الهرمل الفنية العالية - غرفة رقم 5,شيعي,625,386,2,1,384
الهرمل,الهرمل حي الحارة ,مدرسة الهرمل الفنية العالية - غرفة رقم 6,شيعي,643,367,15,0,352
الهرمل,الهرمل حي الحارة ,مدرسة الهرمل الفنية العالية - غرفة رقم 7,شيعي,605,368,4,1,364
الهرمل,الهرمل حي الوقف ,متوسطة الهرمل الرسمية - غرفة رقم 1,شيعي,637,388,6,0,382
الهرمل,الهرمل حي الوقف ,متوسطة الهرمل الرسمية - غرفة رقم 2,شيعي,659,366,9,0,357
الهرمل,الهرمل حي الوقف ,متوسطة الهرمل الرسمية - غرفة رقم 3,شيعي,657,372,4,0,368
الهرمل,الهرمل حي الوقف ,متوسطة الهرمل الرسمية - غرفة رقم 4,شيعي,634,363,9,3,354
الهرمل,الهرمل حي الوقف ,متوسطة الهرمل الرسمية - غرفة رقم 5,مختلف,614,328,2,1,326
الهرمل,الهرمل حي الوقف ,متوسطة الهرمل الرسمية الأولى - غرفة رقم 1,شيعي,688,415,16,0,399
الهرمل,الهرمل حي الوقف ,متوسطة الهرمل الرسمية الأولى - غرفة رقم 2,شيعي,654,367,13,2,354
الهرمل,الهرمل حي الوقف ,متوسطة الهرمل الرسمية الأولى - غرفة رقم 3,شيعي,688,399,0,4,399
الهرمل,الهرمل حي الوقف ,متوسطة الهرمل الرسمية الأولى - غرفة رقم 4,شيعي,652,412,8,2,404
الهرمل,الهرمل حي الوقف ,متوسطة الهرمل الرسمية الأولى - غرفة رقم 5,شيعي,685,390,4,1,386
الهرمل,الهرمل حي بديتا ,متوسطة الهرمل الرسمية الثانية - غرفة رقم 1,شيعي,675,328,14,1,314
الهرمل,الهرمل حي بديتا ,متوسطة الهرمل الرسمية الثانية - غرفة رقم 2,شيعي,656,362,0,0,362
الهرمل,الهرمل حي بديتا ,متوسطة الهرمل الرسمية الثانية - غرفة رقم 3,شيعي,660,390,4,0,386
الهرمل,الهرمل حي بديتا ,متوسطة الهرمل الرسمية الثانية - غرفة رقم 4,شيعي,631,384,13,2,371
الهرمل,الهرمل حي بديتا ,متوسطة الهرمل الرسمية الثانية - غرفة رقم 5,شيعي,650,404,4,0,400
الهرمل,الهرمل حي بديتا ,متوسطة الهرمل الرسمية الثانية - غرفة رقم 6,مسلم,506,315,5,1,310
الهرمل,الهرمل حي بديتا ,مدرسة مهنية الهرمل النموذجية - غرفة رقم 1,شيعي,658,351,3,2,348
الهرمل,الهرمل حي بديتا ,مدرسة مهنية الهرمل النموذجية - غرفة رقم 2,شيعي,642,396,2,0,394
الهرمل,الهرمل حي بديتا ,مدرسة مهنية الهرمل النموذجية - غرفة رقم 3,شيعي,675,427,4,0,423
الهرمل,الهرمل حي بديتا ,مدرسة مهنية الهرمل النموذجية - غرفة رقم 4,شيعي,673,392,14,1,378
الهرمل,بريصا ,المدرسة الرسمية - غرفة رقم 1,شيعي,344,270,1,0,269
الهرمل,جوار الحشيش ,المدرسة الرسمية - غرفة رقم 1,شيعي,658,404,5,3,399
الهرمل,جوار الحشيش ,المدرسة الرسمية - غرفة رقم 2,شيعي,671,421,0,1,421
الهرمل,حميره ,المدرسة الرسمية - غرفة رقم 1,شيعي,564,283,4,0,279
الهرمل,حوش السيد علي ,المدرسة الرسمية - غرفة رقم 1,مختلف,351,222,5,1,217
الهرمل,سهلات الماء ,مدرسة حوش السيد علي الرسمية - غرفة رقم 2,مسلم,281,183,2,2,181
الهرمل,فيسان ,مدرسة فيسان الرسمية - غرفة رقم 2,شيعي,701,481,3,2,478
الهرمل,قنافذ ,المدرسة الرسمية - غرفة رقم 1,شيعي,124,71,0,0,71
الهرمل,مراح العين ,المدرسة الرسمية - غرفة رقم 1,شيعي,269,207,2,1,205
الهرمل,مزرعة الفقيه ,ثانوية الهرمل النموذجية - غرفة رقم 5,شيعي,102,65,2,1,63
الهرمل,مزرعة بيت الطشم ,المدرسة الرسمية - غرفة رقم 1,مسلم,265,184,3,2,181
الهرمل,مزرعة سجد ,المدرسة الرسمية - غرفة رقم 1,شيعي,459,319,3,1,316
الهرمل,وادي التركمان ,مدرسة وادي التركمان - غرفة رقم 1,شيعي,495,247,0,4,247
الهرمل,وادي التركمان ,مدرسة وادي التركمان - غرفة رقم 2,شيعي,503,255,8,0,247
الهرمل,وادي التركمان ,مدرسة وادي التركمان - غرفة رقم 3,شيعي,533,324,3,0,321
الهرمل,وادي الرطل ,المدرسة الرسمية - غرفة رقم 1,مختلف,435,228,5,1,223
الهرمل,وادي الرطل ,المدرسة الرسمية - غرفة رقم 2,مختلف,482,240,4,1,236
الهرمل,وادي العس ,ثانوية الهرمل النموذجية - غرفة رقم 1,مسلم,45,15,0,0,15
الهرمل,وادي الكرم ,ثانوية الهرمل النموذجية - غرفة رقم 2,شيعي,631,435,16,2,419
الهرمل,وادي الكرم ,ثانوية الهرمل النموذجية - غرفة رقم 3,شيعي,673,434,8,0,426
الهرمل,وادي النيرة ,القسم المستأجر من مدرسة زبود الرسمية - غرفة رقم 1,شيعي,406,233,0,2,233
الهرمل,وادي بنيت ,ثانوية الهرمل النموذجية - غرفة رقم 4,شيعي,472,291,5,1,286
بشري,الديمان ,نادي الاتحاد الديماني - غرفة رقم 1,ماروني,455,115,2,1,113
بشري,الديمان ,نادي الاتحاد الديماني - غرفة رقم 2,ماروني,443,118,0,0,118
بشري,الديمان ,نادي الاتحاد الديماني - غرفة رقم 3,ماروني,418,78,0,0,78
بشري,المغر وبلا ,بيت الرعية في بلا - غرفة رقم 1,ماروني,454,234,3,3,231
بشري,بان ,دار البلدية - غرفة رقم 1,ماروني,608,106,3,0,103
بشري,بان ,دار البلدية - غرفة رقم 2,ماروني,618,128,4,1,124
بشري,بان ,دار البلدية - غرفة رقم 3,ماروني,613,59,1,0,58
بشري,برحليون ,دار البلدية - غرفة رقم 1,ماروني,655,263,1,1,262
بشري,برحليون ,دار البلدية - غرفة رقم 2,ماروني,619,290,8,2,282
بشري,بريسات ,بهو الكنيسة - غرفة رقم 1,ماروني,354,129,5,1,124
بشري,بزعون ,دار البلدية - غرفة رقم 1,ماروني,514,242,2,0,240
بشري,بزعون ,دار البلدية - غرفة رقم 2,ماروني,504,228,0,0,228
بشري,بزعون ,دار البلدية - غرفة رقم 3,ماروني,519,273,4,2,269
بشري,بزعون ,دار البلدية - غرفة رقم 4,ماروني,511,267,1,2,266
بشري,بزعون ,دار البلدية - غرفة رقم 5,ماروني,457,48,0,1,48
بشري,بشري حي السيدة ,دار المعلمين - غرفة رقم 1,ماروني,552,259,3,0,256
بشري,بشري حي السيدة ,دار المعلمين - غرفة رقم 2,ماروني,539,278,3,3,275
بشري,بشري حي السيدة ,دار المعلمين - غرفة رقم 3,ماروني,516,212,3,1,209
بشري,بشري حي السيدة ,مدرسة البنات الرسمية - غرفة رقم 1,مسيحي,538,219,2,0,217
بشري,بشري حي السيدة ,مدرسة بشري الفنية الرسمية - غرفة رقم 1,ماروني,565,290,0,2,290
بشري,بشري حي السيدة ,مدرسة بشري الفنية الرسمية - غرفة رقم 2,ماروني,536,190,0,1,190
بشري,بشري حي السيدة ,مدرسة بشري الفنية الرسمية - غرفة رقم 3,ماروني,561,287,7,2,280
بشري,بشري حي السيدة ,مركز الخدمات الإنمائية الشاملة - غرفة رقم 1,ماروني,567,318,12,2,306
بشري,بشري حي السيدة ,مركز الخدمات الإنمائية الشاملة - غرفة رقم 2,ماروني,552,249,4,1,245
بشري,بشري حي السيدة ,مركز الخدمات الإنمائية الشاملة - غرفة رقم 3,ماروني,549,330,1,2,329
بشري,بشري حي السيدة ,مركز الخدمات الإنمائية الشاملة - غرفة رقم 4,ماروني,538,217,4,1,213
بشري,بشري حي المقدمين ,مركز البريد - غرفة رقم 1,ماروني,331,104,0,3,104
بشري,بشري حي المقدمين ,مركز البريد - غرفة رقم 2,ماروني,349,116,3,3,113
بشري,بشري حي مار سابا ,مدرسة الراهبات للعائلة المقدسة - غرفة رقم 1,ماروني,542,262,1,6,261
بشري,بشري حي مار سابا ,مدرسة الراهبات للعائلة المقدسة - غرفة رقم 2,ماروني,528,235,3,4,232
بشري,بشري حي مار سابا ,مدرسة الراهبات للعائلة المقدسة - غرفة رقم 3,ماروني,539,232,3,0,229
بشري,بشري حي مار سابا ,مدرسة الراهبات للعائلة المقدسة - غرفة رقم 4,ماروني,547,277,5,5,272
بشري,بشري حي مار سابا ,مدرسة الراهبات للعائلة المقدسة - غرفة رقم 5,ماروني,524,234,2,0,232
بشري,بشري حي مار سابا ,مدرسة الراهبات للعائلة المقدسة - غرفة رقم 6,ماروني,582,245,5,4,240
بشري,بشري حي مار سابا ,مدرسة الراهبات للعائلة المقدسة - غرفة رقم 7,ماروني,494,186,5,2,181
بشري,بشري حي مار سابا ,مدرسة الراهبات للعائلة المقدسة - غرفة رقم 8,ماروني,492,168,0,2,168
بشري,بشري حي مار يوحنا ,ثانوية بشري - غرفة رقم 1,ماروني,463,195,2,0,193
بشري,بشري حي مار يوحنا ,ثانوية بشري - غرفة رقم 2,ماروني,449,175,0,0,175
بشري,بشري حي مار يوحنا ,مدرسة البنات الرسمية - غرفة رقم 2,ماروني,433,174,1,2,173
بشري,بشري حي مار يوحنا ,مدرسة البنات الرسمية - غرفة رقم 3,ماروني,420,126,2,0,124
بشري,بشري حي مار يوحنا ,مدرسة البنات الرسمية - غرفة رقم 4,ماروني,479,193,0,1,193
بشري,بشري حي مار يوحنا ,مدرسة البنات الرسمية - غرفة رقم 5,ماروني,440,171,3,2,168
بشري,بشري حي مار يوحنا ,مدرسة البنات الرسمية - غرفة رقم 6,ماروني,456,185,0,1,185
بشري,بشري حي مار يوحنا ,مدرسة البنات الرسمية - غرفة رقم 7,ماروني,428,136,0,0,136
بشري,بشري موظفون ,سراي بشري - غرفة رقم 1,مختلف,84,74,0,0,74
بشري,بقاعكفرا ,مركز البلدية الجديد - غرفة رقم 1,ماروني,562,307,0,6,307
بشري,بقاعكفرا ,مركز البلدية الجديد - غرفة رقم 2,ماروني,550,342,7,3,335
بشري,بقاعكفرا ,مركز البلدية الجديد - غرفة رقم 3,ماروني,529,226,2,3,224
بشري,بقاعكفرا ,مركز البلدية الجديد - غرفة رقم 4,ماروني,554,331,1,5,330
بشري,بقاعكفرا ,مركز البلدية الجديد - غرفة رقم 5,ماروني,546,313,3,9,310
بشري,بقاعكفرا ,مركز البلدية الجديد - غرفة رقم 6,ماروني,503,243,4,2,239
بشري,بقرقاشا ,مركز بلدية بقرقاشا - غرفة رقم 1,ماروني,587,223,1,0,222
بشري,بقرقاشا ,مركز بلدية بقرقاشا - غرفة رقم 2,ماروني,581,289,14,3,275
بشري,بقرقاشا ,مركز بلدية بقرقاشا - غرفة رقم 3,ماروني,600,223,1,0,222
بشري,بقرقاشا ,مركز بلدية بقرقاشا - غرفة رقم 4,ماروني,588,344,7,3,337
بشري,بقرقاشا ,مركز بلدية بقرقاشا - غرفة رقم 5,ماروني,576,253,0,0,253
بشري,بلوزا ,مدرسة الراهبات - غرفة رقم 1,ماروني,588,82,0,0,82
بشري,بلوزا ,مدرسة الراهبات - غرفة رقم 2,ماروني,595,105,2,1,103
بشري,بلوزا ,مدرسة الراهبات - غرفة رقم 3,ماروني,573,140,5,0,135
بشري,بيت منذر ,مقر النادي - غرفة رقم 1,ماروني,428,163,3,4,160
بشري,حدث الجبه ,دار البلدية - غرفة رقم 1,ماروني,486,121,1,0,120
بشري,حدث الجبه ,دار البلدية - غرفة رقم 2,مسيحي,469,109,0,0,109
بشري,حدث الجبه ,دار البلدية - غرفة رقم 3,ماروني,439,55,0,0,55
بشري,حدث الجبه ,مدرسة الراهبات - غرفة رقم 1,ماروني,489,127,1,0,126
بشري,حدث الجبه ,مدرسة الراهبات - غرفة رقم 2,ماروني,484,141,0,0,141
بشري,حدشيت ,المدرسة الرسمية - غرفة رقم 1,ماروني,562,191,2,3,189
بشري,حدشيت ,المدرسة الرسمية - غرفة رقم 2,ماروني,562,205,3,1,202
بشري,حدشيت ,المدرسة الرسمية - غرفة رقم 3,ماروني,584,187,3,1,184
بشري,حدشيت ,المدرسة الرسمية - غرفة رقم 4,ماروني,572,182,1,1,181
بشري,حدشيت ,المدرسة الرسمية - غرفة رقم 5,ماروني,555,195,0,2,195
بشري,حدشيت ,المدرسة الرسمية - غرفة رقم 6,ماروني,576,218,1,2,217
بشري,حدشيت ,مدرسة الراهبات - غرفة رقم 1,ماروني,564,231,6,1,225
بشري,حدشيت ,مدرسة الراهبات - غرفة رقم 2,ماروني,570,237,0,2,237
بشري,حدشيت ,مدرسة الراهبات - غرفة رقم 3,ماروني,581,231,1,1,230
بشري,حدشيت ,مدرسة الراهبات - غرفة رقم 4,ماروني,538,228,3,1,225
بشري,حصرون ,المدرسة الرسمية للصبيان - غرفة رقم 1,ماروني,504,210,1,0,209
بشري,حصرون ,المدرسة الرسمية للصبيان - غرفة رقم 2,ماروني,514,207,3,0,204
بشري,حصرون ,المدرسة الرسمية للصبيان - غرفة رقم 3,ماروني,532,255,3,2,252
بشري,حصرون ,المدرسة الرسمية للصبيان - غرفة رقم 4,ماروني,478,88,1,0,87
بشري,حصرون ,المدرسة الرسمية للصبيان - غرفة رقم 5,ماروني,508,236,4,2,232
بشري,حصرون ,المدرسة الرسمية للصبيان - غرفة رقم 6,ماروني,515,229,6,1,223
بشري,حصرون ,دار البلدية - غرفة رقم 1,ماروني,521,260,2,5,258
بشري,حصرون ,دار البلدية - غرفة رقم 2,ماروني,479,88,0,1,88
بشري,دول إقليمية,دول إقليمية,مختلف,1542,1043,20,1,1023
بشري,طورزا ,المدرسة الرسمية - غرفة رقم 1,ماروني,582,74,0,1,74
بشري,طورزا ,المدرسة الرسمية - غرفة رقم 2,ماروني,577,74,1,0,73
بشري,طورزا ,مدرسة الراهبات - غرفة رقم 1,ماروني,559,83,3,0,80
بشري,طورزا ,مدرسة الراهبات - غرفة رقم 2,ماروني,557,79,2,1,77
بشري,عبدين ,مدرسة راهبات الوردية - غرفة رقم 1,ماروني,495,263,5,3,258
بشري,عبدين ,مدرسة راهبات الوردية - غرفة رقم 2,ماروني,483,294,2,2,292
بشري,قنات ,مركز نادي الانعاش الاجتماعي _ دير مار مخايل ) - غرفة رقم 1,ماروني,502,199,0,1,199
بشري,قنات ,مركز نادي الانعاش الاجتماعي _ دير مار مخايل ) - غرفة رقم 2,ماروني,503,203,3,2,200
بشري,قنات ,مركز نادي الانعاش الاجتماعي _ دير مار مخايل ) - غرفة رقم 3,ماروني,504,207,4,1,203
بشري,قنيور ,قاعة الكنيسة - غرفة رقم 1,ماروني,164,38,0,0,38
بشري,مزرعة بني صعب ,المدرسة الرسمية - غرفة رقم 1,ماروني,443,174,1,1,173
بشري,مزرعة عساف ,بيت جاهز في كنيسة الروم الارثوذكس - غرفة رقم 1,مسيحي,337,122,1,0,121
بشري,وادي قنوبين ,معمل كهرباء قديشا - غرفة رقم 1,ماروني,553,109,0,0,109
بشري,وادي قنوبين ,معمل كهرباء قديشا - غرفة رقم 2,ماروني,522,120,2,1,118
بعبدا,ارصون ,مركز البلدية - غرفة رقم 1,مختلف,437,205,0,2,205
بعبدا,ارصون ,مركز البلدية - غرفة رقم 2,مختلف,405,203,1,2,202
بعبدا,الحازميه ,مدرسة الاليزيه - غرفة رقم 1,ماروني,552,315,8,0,307
بعبدا,الحازميه ,مدرسة الاليزيه - غرفة رقم 2,مسيحي,548,252,1,2,251
بعبدا,الحازميه ,مدرسة الاليزيه - غرفة رقم 3,ماروني,575,318,6,2,312
بعبدا,الحازميه ,مدرسة الاليزيه - غرفة رقم 4,مسيحي,546,278,6,3,272
بعبدا,الحازميه ,مدرسة الاليزيه - غرفة رقم 5,مسيحي,535,181,3,0,178
بعبدا,الحدث شمالي ,مدرسة راهبات القلبين الاقدسين في الحدث - غرفة رقم 1,ماروني,573,327,4,0,323
بعبدا,الحدث شمالي ,مدرسة راهبات القلبين الاقدسين في الحدث - غرفة رقم 10,مسيحي,606,204,6,2,198
بعبدا,الحدث شمالي ,مدرسة راهبات القلبين الاقدسين في الحدث - غرفة رقم 2,ماروني,591,329,2,1,327
بعبدا,الحدث شمالي ,مدرسة راهبات القلبين الاقدسين في الحدث - غرفة رقم 3,ماروني,614,330,5,0,325
بعبدا,الحدث شمالي ,مدرسة راهبات القلبين الاقدسين في الحدث - غرفة رقم 4,مختلف,565,192,7,1,185
بعبدا,الحدث شمالي ,مدرسة راهبات القلبين الاقدسين في الحدث - غرفة رقم 5,ماروني,572,318,8,1,310
بعبدا,الحدث شمالي ,مدرسة راهبات القلبين الاقدسين في الحدث - غرفة رقم 6,ماروني,572,302,9,4,293
بعبدا,الحدث شمالي ,مدرسة راهبات القلبين الاقدسين في الحدث - غرفة رقم 7,ماروني,602,321,1,3,320
بعبدا,الحدث شمالي ,مدرسة راهبات القلبين الاقدسين في الحدث - غرفة رقم 8,مسيحي,594,207,2,1,205
بعبدا,الحدث شمالي ,مدرسة راهبات القلبين الاقدسين في الحدث - غرفة رقم 9,مسيحي,597,193,0,1,193
بعبدا,الحدث قبلي ,مدرسة الاخوة الوطنية مقابل الريجي - غرفة رقم 1,ماروني,562,303,0,3,303
بعبدا,الحدث قبلي ,مدرسة الاخوة الوطنية مقابل الريجي - غرفة رقم 2,ماروني,590,265,4,1,261
بعبدا,الحدث قبلي ,مدرسة الاخوة الوطنية مقابل الريجي - غرفة رقم 3,مسيحي,519,209,3,0,206
بعبدا,الحدث قبلي ,مدرسة الاخوة الوطنية مقابل الريجي - غرفة رقم 4,ماروني,552,296,6,4,290
بعبدا,الحدث قبلي ,مدرسة الاخوة الوطنية مقابل الريجي - غرفة رقم 5,مسيحي,570,197,0,2,197
بعبدا,الحدث قبلي ,مدرسة الاخوة الوطنية مقابل الريجي - غرفة رقم 6,ماروني,549,261,0,2,261
بعبدا,الحدث قبلي ,مدرسة الاخوة الوطنية مقابل الريجي - غرفة رقم 7,مختلف,524,147,6,1,141
بعبدا,الحدث قبلي ,مدرسة الاخوة الوطنية مقابل الريجي - غرفة رقم 8,مختلف,553,156,2,0,154
بعبدا,الخريبه ,المدرسة الرسمية - غرفة رقم 1,درزي,615,393,4,2,389
بعبدا,الخلوات ,مدرسة خلوات فالوغا الرسمية - غرفة رقم 1,درزي,518,303,3,4,300
بعبدا,الدليبه ,وقف كنيسة السيدة - غرفة رقم 1,ماروني,333,190,3,2,187
بعبدا,الشبانيه ,المدرسة الرسمية - غرفة رقم 1,ماروني,478,245,7,0,238
بعبدا,الشبانيه ,المدرسة الرسمية - غرفة رقم 2,ماروني,472,248,14,0,234
بعبدا,الشبانيه ,المدرسة الرسمية - غرفة رقم 3,ماروني,425,185,0,2,185
بعبدا,الشبانيه ,المدرسة الرسمية - غرفة رقم 4,درزي,501,316,3,1,313
بعبدا,الشياح بئر العبد ,ثانوية الشياح الرسمية للصبيان (ثانوية المربي شفيق سعد) - غرفة رقم 6,ماروني,475,189,12,4,177
بعبدا,الشياح بئر العبد ,ثانوية الشياح الرسمية للصبيان (ثانوية المربي شفيق سعد) - غرفة رقم 7,مسيحي,436,149,5,0,144
بعبدا,الشياح بئر العبد ,ثانوية الشياح الرسمية للصبيان (ثانوية المربي شفيق سعد) - غرفة رقم 8,ماروني,479,196,5,0,191
بعبدا,الشياح بئر العبد ,ثانوية الشياح الرسمية للصبيان (ثانوية المربي شفيق سعد) - غرفة رقم 9,مسيحي,472,184,8,0,176
بعبدا,الشياح حي الكنيسة ,ثانوية الشياح الرسمية للصبيان (ثانوية المربي شفيق سعد) - غرفة رقم 1,ماروني,530,271,4,3,267
بعبدا,الشياح حي الكنيسة ,ثانوية الشياح الرسمية للصبيان (ثانوية المربي شفيق سعد) - غرفة رقم 2,ماروني,532,164,1,0,163
بعبدا,الشياح حي الكنيسة ,ثانوية الشياح الرسمية للصبيان (ثانوية المربي شفيق سعد) - غرفة رقم 3,ماروني,513,248,13,2,235
بعبدا,الشياح حي الكنيسة ,ثانوية الشياح الرسمية للصبيان (ثانوية المربي شفيق سعد) - غرفة رقم 4,مسيحي,520,237,3,1,234
بعبدا,الشياح حي الكنيسة ,ثانوية الشياح الرسمية للصبيان (ثانوية المربي شفيق سعد) - غرفة رقم 5,مسيحي,487,69,0,0,69
بعبدا,الشياح حي كرم الزيتون ,ثانوية الشياح الرسمية للصبيان (ثانوية المربي شفيق سعد) - غرفة رقم 10,ماروني,582,333,8,2,325
بعبدا,الشياح حي كرم الزيتون ,ثانوية الشياح الرسمية للصبيان (ثانوية المربي شفيق سعد) - غرفة رقم 11,ماروني,574,293,5,2,288
بعبدا,الشياح حي كرم الزيتون ,ثانوية الشياح الرسمية للصبيان (ثانوية المربي شفيق سعد) - غرفة رقم 12,مسيحي,569,243,10,1,233
بعبدا,الشياح حي كرم الزيتون ,ثانوية الشياح الرسمية للصبيان (ثانوية المربي شفيق سعد) - غرفة رقم 13,ماروني,581,315,5,1,310
بعبدا,الشياح حي كرم الزيتون ,ثانوية الشياح الرسمية للصبيان (ثانوية المربي شفيق سعد) - غرفة رقم 14,روم كاثوليك,576,230,0,0,230
بعبدا,الشياح حي كرم الزيتون ,مدرسة الشياح الرسميــــة الثانية للبنات ( لمع لمع ) - غرفة رقم 1,روم ارثوذكس,580,201,2,0,199
بعبدا,الشياح حي كرم الزيتون ,مدرسة الشياح الرسميــــة الثانية للبنات ( لمع لمع ) - غرفة رقم 2,ماروني,574,291,0,4,291
بعبدا,الشياح حي كرم الزيتون ,مدرسة الشياح الرسميــــة الثانية للبنات ( لمع لمع ) - غرفة رقم 3,مسيحي,551,245,8,0,237
بعبدا,الشياح حي كرم الزيتون ,مدرسة الشياح الرسميــــة الثانية للبنات ( لمع لمع ) - غرفة رقم 4,مختلف,568,242,13,2,229
بعبدا,العباديه ,المدرسة الرسمية - غرفة رقم 1,درزي,554,240,2,3,238
بعبدا,العباديه ,المدرسة الرسمية - غرفة رقم 10,مختلف,543,175,2,0,173
بعبدا,العباديه ,المدرسة الرسمية - غرفة رقم 2,درزي,566,231,5,1,226
بعبدا,العباديه ,المدرسة الرسمية - غرفة رقم 3,مختلف,546,200,6,1,194
بعبدا,العباديه ,المدرسة الرسمية - غرفة رقم 4,روم ارثوذكس,521,201,2,0,199
بعبدا,العباديه ,المدرسة الرسمية - غرفة رقم 5,ماروني,565,283,3,1,280
بعبدا,العباديه ,المدرسة الرسمية - غرفة رقم 6,ماروني,552,284,7,1,277
بعبدا,العباديه ,المدرسة الرسمية - غرفة رقم 7,درزي,552,209,0,1,209
بعبدا,العباديه ,المدرسة الرسمية - غرفة رقم 8,درزي,546,172,0,5,172
بعبدا,العباديه ,المدرسة الرسمية - غرفة رقم 9,ماروني,532,175,5,1,170
بعبدا,العربانية ,صالون كنيسة سيدة الانتقال - غرفة رقم 1,ماروني,386,181,4,1,177
بعبدا,العربانية ,صالون كنيسة سيدة الانتقال - غرفة رقم 2,ماروني,417,177,0,1,177
بعبدا,الغبيري بئر حسن ,ثانوية الغبيري الاولى للبنات - غرفة رقم 1,سني,628,150,5,3,145
بعبدا,الغبيري بئر حسن ,ثانوية الغبيري الاولى للبنات - غرفة رقم 2,سني,638,74,1,0,73
بعبدا,الغبيري بئر حسن ,ثانوية الغبيري الاولى للبنات - غرفة رقم 3,سني,663,258,15,5,243
بعبدا,الغبيري بئر حسن ,ثانوية الغبيري الاولى للبنات - غرفة رقم 4,سني,625,92,3,6,89
بعبدا,الغبيري بئر حسن ,ثانوية الغبيري الاولى للبنات - غرفة رقم 5,سني,612,78,4,2,74
بعبدا,الغبيري بئر حسن ,ثانوية الغبيري الاولى للبنات - غرفة رقم 6,سني,657,156,4,2,152
بعبدا,الغبيري بئر حسن ,ثانوية الغبيري الاولى للبنات - غرفة رقم 7,مسلم,627,201,5,7,196
بعبدا,الغبيري بئر حسن ,ثانوية الغبيري الاولى للبنات - غرفة رقم 8,مسلم,624,243,14,5,229
بعبدا,الغبيري بئر حسن ,مدرسة الشهيد عبد الكريم الخليل - غرفة رقم 1,شيعي,633,295,5,3,290
بعبدا,الغبيري بئر حسن ,مدرسة الشهيد عبد الكريم الخليل - غرفة رقم 10,شيعي,625,348,12,3,336
بعبدا,الغبيري بئر حسن ,مدرسة الشهيد عبد الكريم الخليل - غرفة رقم 11,شيعي,616,311,6,6,305
بعبدا,الغبيري بئر حسن ,مدرسة الشهيد عبد الكريم الخليل - غرفة رقم 12,شيعي,634,302,18,3,284
بعبدا,الغبيري بئر حسن ,مدرسة الشهيد عبد الكريم الخليل - غرفة رقم 13,شيعي,621,270,8,2,262
بعبدا,الغبيري بئر حسن ,مدرسة الشهيد عبد الكريم الخليل - غرفة رقم 14,شيعي,656,308,2,1,306
بعبدا,الغبيري بئر حسن ,مدرسة الشهيد عبد الكريم الخليل - غرفة رقم 2,شيعي,634,390,5,2,385
بعبدا,الغبيري بئر حسن ,مدرسة الشهيد عبد الكريم الخليل - غرفة رقم 3,شيعي,625,349,5,2,344
بعبدا,الغبيري بئر حسن ,مدرسة الشهيد عبد الكريم الخليل - غرفة رقم 4,شيعي,600,333,7,3,326
بعبدا,الغبيري بئر حسن ,مدرسة الشهيد عبد الكريم الخليل - غرفة رقم 5,شيعي,611,316,9,0,307
بعبدا,الغبيري بئر حسن ,مدرسة الشهيد عبد الكريم الخليل - غرفة رقم 6,شيعي,601,294,4,2,290
بعبدا,الغبيري بئر حسن ,مدرسة الشهيد عبد الكريم الخليل - غرفة رقم 7,شيعي,642,327,27,1,300
بعبدا,الغبيري بئر حسن ,مدرسة الشهيد عبد الكريم الخليل - غرفة رقم 8,شيعي,279,278,0,1,278
بعبدا,الغبيري بئر حسن ,مدرسة الشهيد عبد الكريم الخليل - غرفة رقم 9,شيعي,611,339,16,1,323
بعبدا,الغبيري حي الجامع ,مدرسة الغبيري الرسمية الثانية للبنات - غرفة رقم 1,شيعي,637,342,7,2,335
بعبدا,الغبيري حي الجامع ,مدرسة الغبيري الرسمية الثانية للبنات - غرفة رقم 10,شيعي,583,267,7,0,260
بعبدا,الغبيري حي الجامع ,مدرسة الغبيري الرسمية الثانية للبنات - غرفة رقم 11,شيعي,552,242,5,5,237
بعبدا,الغبيري حي الجامع ,مدرسة الغبيري الرسمية الثانية للبنات - غرفة رقم 12,شيعي,597,329,5,0,324
بعبدا,الغبيري حي الجامع ,مدرسة الغبيري الرسمية الثانية للبنات - غرفة رقم 13,شيعي,583,246,3,2,243
بعبدا,الغبيري حي الجامع ,مدرسة الغبيري الرسمية الثانية للبنات - غرفة رقم 14,شيعي,578,269,3,2,266
بعبدا,الغبيري حي الجامع ,مدرسة الغبيري الرسمية الثانية للبنات - غرفة رقم 15,شيعي,566,286,5,0,281
بعبدا,الغبيري حي الجامع ,مدرسة الغبيري الرسمية الثانية للبنات - غرفة رقم 2,شيعي,612,307,6,3,301
بعبدا,الغبيري حي الجامع ,مدرسة الغبيري الرسمية الثانية للبنات - غرفة رقم 3,شيعي,616,295,4,4,291
بعبدا,الغبيري حي الجامع ,مدرسة الغبيري الرسمية الثانية للبنات - غرفة رقم 4,شيعي,635,339,10,1,329
بعبدا,الغبيري حي الجامع ,مدرسة الغبيري الرسمية الثانية للبنات - غرفة رقم 5,شيعي,652,312,9,3,303
بعبدا,الغبيري حي الجامع ,مدرسة الغبيري الرسمية الثانية للبنات - غرفة رقم 6,شيعي,649,301,14,1,287
بعبدا,الغبيري حي الجامع ,مدرسة الغبيري الرسمية الثانية للبنات - غرفة رقم 7,شيعي,662,309,7,0,302
بعبدا,الغبيري حي الجامع ,مدرسة الغبيري الرسمية الثانية للبنات - غرفة رقم 8,شيعي,578,279,8,4,271
بعبدا,الغبيري حي الجامع ,مدرسة الغبيري الرسمية الثانية للبنات - غرفة رقم 9,شيعي,600,300,11,3,289
بعبدا,الفياضية ,صالون القديسة تريزيا - غرفة رقم 1,مسيحي,225,122,3,1,119
بعبدا,القريه ,متوسطة القرية الرسمية - غرفة رقم 1,درزي,423,215,2,1,213
بعبدا,القريه ,متوسطة القرية الرسمية - غرفة رقم 2,درزي,434,230,5,3,225
بعبدا,القصيبه ,دار البلدية - غرفة رقم 1,مسيحي,378,228,1,0,227
بعبدا,القصيبه ,دار البلدية - غرفة رقم 2,مسيحي,413,255,6,1,249
بعبدا,القلعه ,الخلية - غرفة رقم 1,درزي,477,234,2,5,232
بعبدا,الكنيسه ,صالون كنيسة مار انطونيوس - غرفة رقم 1,ماروني,286,115,0,3,115
بعبدا,اللويزه ,غرفة مجاورة لصالون كنيسة مار جرجس (اللويزة) - غرفة رقم 1,مسيحي,529,340,5,1,335
بعبدا,الليلكه ,مدرسة الليلكه الرسمية المختلطة - غرفة رقم 1,ماروني,564,288,4,1,284
بعبدا,الليلكه ,مدرسة الليلكه الرسمية المختلطة - غرفة رقم 2,ماروني,605,308,7,0,301
بعبدا,الليلكه ,مدرسة الليلكه الرسمية المختلطة - غرفة رقم 3,ماروني,574,255,1,1,254
بعبدا,المرداشة ,صالون كنيسة سيدة النجاة - غرفة رقم 1,ماروني,198,67,0,0,67
بعبدا,المريجه ,مدرسة الاخوة – شارع الرئيس اليافي - غرفة رقم 4,ماروني,514,219,2,0,217
بعبدا,المريجه ,مدرسة الاخوة – شارع الرئيس اليافي - غرفة رقم 5,ماروني,527,231,4,0,227
بعبدا,المريجه ,مدرسة الاخوة – شارع الرئيس اليافي - غرفة رقم 6,مسيحي,537,171,10,2,161
بعبدا,الهلالية ,المدرسة الرسمية - غرفة رقم 1,درزي,357,206,6,0,200
بعبدا,الهلالية ,المدرسة الرسمية - غرفة رقم 2,درزي,339,189,1,1,188
بعبدا,بتبيات ,الخلية - غرفة رقم 1,درزي,370,217,13,3,204
بعبدا,بتخنيه ,المدرسة الرسمية - غرفة رقم 1,درزي,470,172,0,0,172
بعبدا,بتخنيه ,المدرسة الرسمية - غرفة رقم 2,درزي,460,212,1,0,211
بعبدا,بتخنيه ,المدرسة الرسمية - غرفة رقم 3,درزي,470,193,0,1,193
بعبدا,برج البراجنة حي السنديان ,مدرسة برج البراجنة الرسمية الاولى المختلطة - غرفة رقم 1,شيعي,613,311,8,6,303
بعبدا,برج البراجنة حي السنديان ,مدرسة برج البراجنة الرسمية الاولى المختلطة - غرفة رقم 2,شيعي,609,332,13,4,319
بعبدا,برج البراجنة حي السنديان ,مدرسة برج البراجنة الرسمية الاولى المختلطة - غرفة رقم 3,شيعي,578,314,18,8,296
بعبدا,برج البراجنة حي السنديان ,مدرسة برج البراجنة الرسمية الاولى المختلطة - غرفة رقم 4,شيعي,640,320,11,5,309
بعبدا,برج البراجنة حي السنديان ,مدرسة برج البراجنة الرسمية الاولى المختلطة - غرفة رقم 5,شيعي,590,289,0,0,289
بعبدا,برج البراجنة حي السنديان ,مدرسة برج البراجنة الرسمية الاولى المختلطة - غرفة رقم 6,شيعي,603,332,2,1,330
بعبدا,برج البراجنة حي السنديان ,مدرسة برج البراجنة الرسمية الاولى المختلطة - غرفة رقم 7,مسلم,630,337,3,4,334
بعبدا,برج البراجنة حي السياد ,التكميلية الثالثـــة المختلطـــة السياد - غرفة رقم 1,سني,612,226,3,9,223
بعبدا,برج البراجنة حي السياد ,التكميلية الثالثـــة المختلطـــة السياد - غرفة رقم 2,شيعي,586,395,14,4,381
بعبدا,برج البراجنة حي السياد ,التكميلية الثالثـــة المختلطـــة السياد - غرفة رقم 3,شيعي,561,333,6,9,327
بعبدا,برج البراجنة حي السياد ,التكميلية الثالثـــة المختلطـــة السياد - غرفة رقم 4,شيعي,598,323,15,4,308
بعبدا,برج البراجنة حي السياد ,التكميلية الثالثـــة المختلطـــة السياد - غرفة رقم 5,شيعي,606,364,0,0,364
بعبدا,برج البراجنة حي السياد ,التكميلية الثالثـــة المختلطـــة السياد - غرفة رقم 6,شيعي,602,329,6,2,323
بعبدا,برج البراجنة حي السياد ,التكميلية الثالثـــة المختلطـــة السياد - غرفة رقم 7,مختلف,671,302,3,4,299
بعبدا,برج البراجنة حي السياد ,التكميلية الثالثـــة المختلطـــة السياد - غرفة رقم 8,شيعي,571,364,13,2,351
بعبدا,برج البراجنة حي السياد ,المدرسة الرسمية الاولى للصبيان الرمل - غرفة رقم 1,شيعي,609,339,1,3,338
بعبدا,برج البراجنة حي السياد ,المدرسة الرسمية الاولى للصبيان الرمل - غرفة رقم 2,شيعي,591,335,3,4,332
بعبدا,برج البراجنة حي السياد ,المدرسة الرسمية الاولى للصبيان الرمل - غرفة رقم 3,شيعي,588,330,4,4,326
بعبدا,برج البراجنة حي السياد ,المدرسة الرسمية الاولى للصبيان الرمل - غرفة رقم 4,شيعي,638,373,6,1,367
بعبدا,برج البراجنة حي السياد ,المدرسة الرسمية الاولى للصبيان الرمل - غرفة رقم 5,شيعي,671,344,5,1,339
بعبدا,برج البراجنة حي المنشية ,مدرسة برج البراجنة الرسمية الخامسة المختلطة - غرفة رقم 1,مسلم,553,181,10,0,171
بعبدا,برج البراجنة حي المنشية ,مدرسة برج البراجنة الرسمية الخامسة المختلطة - غرفة رقم 2,شيعي,620,324,7,3,317
بعبدا,برج البراجنة حي المنشية ,مدرسة برج البراجنة الرسمية الخامسة المختلطة - غرفة رقم 3,شيعي,621,365,7,3,358
بعبدا,برج البراجنة حي المنشية ,مدرسة برج البراجنة الرسمية الخامسة المختلطة - غرفة رقم 4,شيعي,565,285,12,2,273
بعبدا,برج البراجنة حي المنشية ,مدرسة برج البراجنة الرسمية الخامسة المختلطة - غرفة رقم 5,شيعي,639,332,12,2,320
بعبدا,برج البراجنة حي المنشية ,مدرسة برج البراجنة الرسمية الخامسة المختلطة - غرفة رقم 6,شيعي,605,318,6,4,312
بعبدا,برج البراجنة حي المنشية ,مدرسة برج البراجنة الرسمية الخامسة المختلطة - غرفة رقم 7,شيعي,619,325,10,7,315
بعبدا,برج البراجنة حي المنشية ,مدرسة برج البراجنة الرسمية الخامسة المختلطة - غرفة رقم 8,شيعي,600,268,10,1,258
بعبدا,برج البراجنة حي المنشية ,مدرسة برج البراجنة الرسمية الخامسة المختلطة - غرفة رقم 9,شيعي,616,318,5,1,313
بعبدا,بزبدين ,المدرسة الرسمية - غرفة رقم 1,ماروني,582,295,0,1,295
بعبدا,بزبدين ,المدرسة الرسمية - غرفة رقم 2,مختلف,618,300,3,3,297
بعبدا,بزبدين ,مركز البلدية - غرفة رقم 1,ماروني,599,327,4,1,323
بعبدا,بزبدين ,مركز البلدية - غرفة رقم 2,مختلف,565,261,6,1,255
بعبدا,بسابا ,دار البلدية - غرفة رقم 1,مسيحي,525,358,0,2,358
بعبدا,بطشيه ,صالون كنيسة بشارة السيدة للروم الارثوذكس - غرفة رقم 1,مسيحي,270,125,0,0,125
بعبدا,بعبدا ,مدرسة بعبدا الرسمية للبنات - غرفة رقم 1,ماروني,553,281,22,0,259
بعبدا,بعبدا ,مدرسة بعبدا الرسمية للبنات - غرفة رقم 2,ماروني,565,258,5,1,253
بعبدا,بعبدا ,مدرسة بعبدا الرسمية للبنات - غرفة رقم 3,ماروني,592,239,1,0,238
بعبدا,بعبدا ,مدرسة بعبدا الرسمية للبنات - غرفة رقم 4,ماروني,541,246,4,0,242
بعبدا,بعبدا ,مدرسة بعبدا الرسمية للبنات - غرفة رقم 5,ماروني,568,269,2,4,267
بعبدا,بعبدا ,مدرسة بعبدا الرسمية للبنات - غرفة رقم 6,مسيحي,518,252,4,1,248
بعبدا,بعبدا ,مدرسة بعبدا الرسمية للبنات - غرفة رقم 7,مختلف,630,168,7,4,161
بعبدا,بعبدا ,مدرسة بعبدا الرسمية للبنات - غرفة رقم 8,مختلف,588,166,3,4,163
بعبدا,بعبدا ,مدرسة بعبدا الرسمية للبنات - غرفة رقم 9,مسيحي,577,226,3,0,223
بعبدا,بعبدا موظفون ,سراي بعبدا - غرفة رقم 1,مختلف,339,293,1,6,292
بعبدا,بعلشميه ,المدرسة الرسمية - غرفة رقم 1,درزي,505,302,10,2,292
بعبدا,بعلشميه ,المدرسة الرسمية - غرفة رقم 2,درزي,495,256,2,3,254
بعبدا,بعلشميه ,المدرسة الرسمية - غرفة رقم 3,درزي,497,261,7,2,254
بعبدا,بعلشميه ,المدرسة الرسمية - غرفة رقم 4,درزي,490,259,2,3,257
بعبدا,بمريم ,المدرسة الرسمية - غرفة رقم 1,مختلف,573,316,3,0,313
بعبدا,بمريم ,المدرسة الرسمية - غرفة رقم 2,مختلف,562,277,0,4,277
بعبدا,تحويطة الغدير ,مدرسة الليلكي الرسمية - غرفة رقم 1,ماروني,500,247,1,0,246
بعبدا,تحويطة الغدير ,مدرسة الليلكي الرسمية - غرفة رقم 2,ماروني,504,242,4,0,238
بعبدا,تحويطة الغدير ,مدرسة الليلكي الرسمية - غرفة رقم 3,مختلف,558,318,3,4,315
بعبدا,تحويطة النهر ,بلدية فرن الشباك - غرفة رقم 1,مسيحي,531,144,5,0,139
بعبدا,تحويطة النهر ,بلدية فرن الشباك - غرفة رقم 2,مسيحي,552,44,1,1,43
بعبدا,تحويطة النهر ,تكميلية فرن الشباك الرسمية للبنات - غرفة رقم 1,ماروني,574,282,3,4,279
بعبدا,تحويطة النهر ,تكميلية فرن الشباك الرسمية للبنات - غرفة رقم 2,ماروني,546,287,2,0,285
بعبدا,تحويطة النهر ,تكميلية فرن الشباك الرسمية للبنات - غرفة رقم 3,مختلف,546,169,6,1,163
بعبدا,تحويطة النهر ,تكميلية فرن الشباك الرسمية للبنات - غرفة رقم 4,ماروني,574,272,7,3,265
بعبدا,تحويطة النهر ,تكميلية فرن الشباك الرسمية للبنات - غرفة رقم 5,ماروني,563,276,1,1,275
بعبدا,تحويطة النهر ,تكميلية فرن الشباك الرسمية للبنات - غرفة رقم 6,ماروني,568,211,1,2,210
بعبدا,تحويطة النهر ,مدرسة فرن الشباك المتوسطة المختلطة – قرب بلدية فرن الشباك - غرفة رقم 1,روم ارثوذكس,569,257,2,0,255
بعبدا,تحويطة النهر ,مدرسة فرن الشباك المتوسطة المختلطة – قرب بلدية فرن الشباك - غرفة رقم 2,روم ارثوذكس,567,250,4,0,246
بعبدا,تحويطة النهر ,مدرسة فرن الشباك المتوسطة المختلطة – قرب بلدية فرن الشباك - غرفة رقم 3,مسيحي,557,90,4,0,86
بعبدا,تحويطة النهر ,مدرسة فرن الشباك المتوسطة المختلطة – قرب بلدية فرن الشباك - غرفة رقم 4,روم كاثوليك,554,152,0,1,152
بعبدا,تحويطة النهر ,مدرسة فرن الشباك المتوسطة المختلطة – قرب بلدية فرن الشباك - غرفة رقم 5,روم كاثوليك,550,160,6,1,154
بعبدا,ترشيش ,مبنى بلدية ترشيش - غرفة رقم 1,ماروني,594,404,28,2,376
بعبدا,ترشيش ,مبنى بلدية ترشيش - غرفة رقم 2,سني,614,246,0,0,246
بعبدا,ترشيش ,مبنى بلدية ترشيش - غرفة رقم 3,مختلف,605,343,7,2,336
بعبدا,جوار الحوز ,مركز البلدية - غرفة رقم 1,ماروني,391,222,2,1,220
بعبدا,جوار الحوز ,مركز البلدية - غرفة رقم 2,ماروني,392,224,11,2,213
بعبدا,جورة ارصون ,كنيسة السيدة - غرفة رقم 1,روم ارثوذكس,223,99,3,3,96
بعبدا,حارة البطم ,مدرسة ابتدائية الحدث الرسمية (مار الياس الحدث) - غرفة رقم 1,مسيحي,423,213,4,1,209
بعبدا,حارة البطم ,مدرسة ابتدائية الحدث الرسمية (مار الياس الحدث) - غرفة رقم 2,ماروني,425,190,0,0,190
بعبدا,حارة البطم ,مدرسة ابتدائية الحدث الرسمية (مار الياس الحدث) - غرفة رقم 3,مسيحي,397,157,1,0,156
بعبدا,حارة الست ,دار البلدية - غرفة رقم 1,ماروني,461,307,2,1,305
بعبدا,حارة حريك حي الرويس ,مركز بلدية حارة حريك للتدريب المهني قرب كنيسة مار يوسف - غرفة رقم 1,ماروني,505,245,8,1,237
بعبدا,حارة حريك حي الرويس ,مركز بلدية حارة حريك للتدريب المهني قرب كنيسة مار يوسف - غرفة رقم 2,ماروني,488,164,2,0,162
بعبدا,حارة حريك حي الرويس ,مركز بلدية حارة حريك للتدريب المهني قرب كنيسة مار يوسف - غرفة رقم 3,ماروني,496,236,9,0,227
بعبدا,حارة حريك حي الرويس ,مركز بلدية حارة حريك للتدريب المهني قرب كنيسة مار يوسف - غرفة رقم 4,ماروني,518,160,4,3,156
بعبدا,حارة حريك حي الكنيسة ,مركز بلدية حارة حريك للتدريب المهني - غرفة رقم 10,ماروني,487,261,4,3,257
بعبدا,حارة حريك حي الكنيسة ,مركز بلدية حارة حريك للتدريب المهني - غرفة رقم 11,مسيحي,473,142,5,1,137
بعبدا,حارة حريك حي الكنيسة ,مركز بلدية حارة حريك للتدريب المهني - غرفة رقم 5,ماروني,520,270,8,1,262
بعبدا,حارة حريك حي الكنيسة ,مركز بلدية حارة حريك للتدريب المهني - غرفة رقم 6,ماروني,495,243,2,1,241
بعبدا,حارة حريك حي الكنيسة ,مركز بلدية حارة حريك للتدريب المهني - غرفة رقم 7,مسيحي,517,275,6,0,269
بعبدا,حارة حريك حي الكنيسة ,مركز بلدية حارة حريك للتدريب المهني - غرفة رقم 8,ماروني,536,280,5,1,275
بعبدا,حارة حريك حي الكنيسة ,مركز بلدية حارة حريك للتدريب المهني - غرفة رقم 9,مسيحي,518,237,1,4,236
بعبدا,حارة حريك قرانوح ,ثانوية حارة حريك - غرفة رقم 1,شيعي,604,333,9,2,324
بعبدا,حارة حريك قرانوح ,ثانوية حارة حريك - غرفة رقم 10,مسلم,594,108,2,0,106
بعبدا,حارة حريك قرانوح ,ثانوية حارة حريك - غرفة رقم 2,شيعي,629,298,4,3,294
بعبدا,حارة حريك قرانوح ,ثانوية حارة حريك - غرفة رقم 3,شيعي,642,342,5,2,337
بعبدا,حارة حريك قرانوح ,ثانوية حارة حريك - غرفة رقم 4,شيعي,622,331,10,3,321
بعبدا,حارة حريك قرانوح ,ثانوية حارة حريك - غرفة رقم 5,شيعي,628,351,6,1,345
بعبدا,حارة حريك قرانوح ,ثانوية حارة حريك - غرفة رقم 6,شيعي,618,302,7,1,295
بعبدا,حارة حريك قرانوح ,ثانوية حارة حريك - غرفة رقم 7,شيعي,641,342,27,3,315
بعبدا,حارة حريك قرانوح ,ثانوية حارة حريك - غرفة رقم 8,شيعي,630,303,3,1,300
بعبدا,حارة حريك قرانوح ,ثانوية حارة حريك - غرفة رقم 9,مسلم,597,172,9,1,163
بعبدا,حارة حمزه ,دير الكحلونية - غرفة رقم 2,ماروني,191,105,2,1,103
بعبدا,حاصبيا المتن ,مدرسة البلدة - غرفة رقم 1,ماروني,335,218,0,0,218
بعبدا,حاصبيا المتن ,مدرسة البلدة - غرفة رقم 2,ماروني,345,212,0,1,212
بعبدا,حمانا ,ثانوية حمانا الرسمية - غرفة رقم 1,مسيحي,434,172,4,2,168
بعبدا,حمانا ,ثانوية حمانا الرسمية - غرفة رقم 2,مسيحي,478,169,1,1,168
بعبدا,حمانا ,ثانوية حمانا الرسمية - غرفة رقم 3,ماروني,516,270,6,0,264
بعبدا,حمانا ,ثانوية حمانا الرسمية - غرفة رقم 4,ماروني,542,240,1,2,239
بعبدا,حمانا ,ثانوية حمانا الرسمية - غرفة رقم 5,ماروني,506,177,3,0,174
بعبدا,حمانا ,ثانوية حمانا الرسمية - غرفة رقم 6,ماروني,520,267,12,6,255
بعبدا,حمانا ,ثانوية حمانا الرسمية - غرفة رقم 7,ماروني,519,226,5,0,221
بعبدا,حمانا ,ثانوية حمانا الرسمية - غرفة رقم 8,ماروني,523,216,5,1,211
بعبدا,حمانا ,ثانوية حمانا الرسمية - غرفة رقم 9,مختلف,531,203,9,0,194
بعبدا,دول إقليمية,دول إقليمية,مختلف,4037,2403,44,10,2359
بعبدا,دير الحرف ,دير الراهبات - غرفة رقم 1,ماروني,542,253,5,2,248
بعبدا,دير خونا ,دير الكحلونية - غرفة رقم 3,روم ارثوذكس,14,3,0,0,3
بعبدا,دير مار الياس الكحلونية ,دير الكحلونية - غرفة رقم 1,ماروني,144,109,1,1,108
بعبدا,راس الحرف ,صالون كنيسة سيدة الانتقال - غرفة رقم 1,ماروني,479,283,18,4,265
بعبدا,راس الحرف ,صالون كنيسة سيدة الانتقال - غرفة رقم 2,ماروني,482,273,4,2,269
بعبدا,راس المتن ,ثانوية راس المتن الرسمية - غرفة رقم 1,درزي,583,282,2,2,280
بعبدا,راس المتن ,ثانوية راس المتن الرسمية - غرفة رقم 2,درزي,538,314,4,1,310
بعبدا,راس المتن ,ثانوية راس المتن الرسمية - غرفة رقم 3,درزي,558,302,4,5,298
بعبدا,راس المتن ,ثانوية راس المتن الرسمية - غرفة رقم 4,درزي,556,286,3,0,283
بعبدا,راس المتن ,ثانوية راس المتن الرسمية - غرفة رقم 5,درزي,595,302,3,3,299
بعبدا,راس المتن ,ثانوية راس المتن الرسمية - غرفة رقم 6,درزي,582,316,3,3,313
بعبدا,راس المتن ,ثانوية راس المتن الرسمية - غرفة رقم 7,درزي,605,278,5,2,273
بعبدا,راس المتن ,ثانوية راس المتن الرسمية - غرفة رقم 8,درزي,583,287,3,2,284
بعبدا,راس المتن ,ثانوية راس المتن الرسمية - غرفة رقم 9,روم ارثوذكس,525,94,0,0,94
بعبدا,رويسة البلوط ,المدرسة الرسمية - غرفة رقم 1,درزي,279,113,2,1,111
بعبدا,رويسة البلوط ,المدرسة الرسمية - غرفة رقم 2,درزي,772,396,3,1,393
بعبدا,رويسة البلوط ,منزل جاهز - غرفة رقم 3,درزي,64,59,1,0,58
بعبدا,زندوقه ,كنيسة مار يوسف - غرفة رقم 1,ماروني,192,115,1,0,114
بعبدا,سبنيه ,الجامعة الاميركية للثقافة و التعليم الفرع الفندقي في الحدث قبلي - غرفة رقم 1,مختلف,509,235,10,1,225
بعبدا,سبنيه ,الجامعة الاميركية للثقافة و التعليم الفرع الفندقي في الحدث قبلي - غرفة رقم 2,مسيحي,532,223,3,1,220
بعبدا,سبنيه ,الجامعة الاميركية للثقافة و التعليم الفرع الفندقي في الحدث قبلي - غرفة رقم 3,مسيحي,487,230,8,0,222
بعبدا,سبنيه ,الجامعة الاميركية للثقافة و التعليم الفرع الفندقي في الحدث قبلي - غرفة رقم 4,مختلف,493,129,4,2,125
بعبدا,شويت ,دار البلدية - غرفة رقم 1,مختلف,516,286,4,2,282
بعبدا,شويت ,دار البلدية - غرفة رقم 2,مختلف,463,207,7,0,200
بعبدا,شويت ,دار البلدية - غرفة رقم 3,مختلف,501,256,5,1,251
بعبدا,صليما ,المدرسة التكميلية الرسمية - غرفة رقم 1,درزي,500,285,5,1,280
بعبدا,صليما ,المدرسة التكميلية الرسمية - غرفة رقم 2,درزي,513,233,2,1,231
بعبدا,صليما ,المدرسة التكميلية الرسمية - غرفة رقم 3,مختلف,467,185,5,0,180
بعبدا,صليما ,المدرسة التكميلية الرسمية - غرفة رقم 4,درزي,526,294,6,3,288
بعبدا,صليما ,المدرسة التكميلية الرسمية - غرفة رقم 5,درزي,515,251,2,1,249
بعبدا,صليما ,المدرسة التكميلية الرسمية - غرفة رقم 6,مختلف,493,179,1,1,178
بعبدا,عاريا ,كنيسة سيدة النجاة الطابق السفلي - غرفة رقم 1,ماروني,481,268,2,1,266
بعبدا,عاريا ,كنيسة سيدة النجاة الطابق السفلي - غرفة رقم 2,ماروني,469,270,4,0,266
بعبدا,عاريا ,كنيسة سيدة النجاة الطابق السفلي - غرفة رقم 3,مسيحي,465,196,3,1,193
بعبدا,عاريا ,كنيسة سيدة النجاة الطابق السفلي - غرفة رقم 4,مسيحي,437,181,4,0,177
بعبدا,عين الرمانة ,مدرسة الفرير– فرن الشباك مقابل كلية الفنون - غرفة رقم 1,مسيحي,534,175,7,1,168
بعبدا,عين الرمانة ,مدرسة الفرير– فرن الشباك مقابل كلية الفنون - غرفة رقم 2,مسيحي,541,165,16,1,149
بعبدا,عين الرمانة ,مدرسة الفرير– فرن الشباك مقابل كلية الفنون - غرفة رقم 3,مختلف,0,0,0,0,0
بعبدا,عين الرمانة ,مدرسة الفرير– فرن الشباك مقابل كلية الفنون - غرفة رقم 4,مختلف,550,144,0,0,144
بعبدا,عين الرمانة ,مدرسة الفرير– فرن الشباك مقابل كلية الفنون - غرفة رقم 5,مسيحي,255,255,2,1,253
بعبدا,عين الرمانة ,مدرسة الفرير– فرن الشباك مقابل كلية الفنون - غرفة رقم 6,مسيحي,501,134,2,0,132
بعبدا,عين الرمانة ,مدرسة الفرير– فرن الشباك مقابل كلية الفنون - غرفة رقم 7,ماروني,533,234,3,2,231
بعبدا,عين الرمانة ,مدرسة الفرير– فرن الشباك مقابل كلية الفنون - غرفة رقم 8,مسيحي,490,156,2,1,154
بعبدا,عين موفق ,صالون كنيسة مار شربل - غرفة رقم 4,ماروني,223,143,7,2,136
بعبدا,فالوغا ,المدرسة الرسمية - غرفة رقم 1,ماروني,474,224,3,1,221
بعبدا,فالوغا ,المدرسة الرسمية - غرفة رقم 2,مسيحي,493,214,2,3,212
بعبدا,فالوغا ,المدرسة الرسمية - غرفة رقم 3,درزي,539,322,4,2,318
بعبدا,فالوغا ,المدرسة الرسمية - غرفة رقم 4,مسيحي,454,221,1,0,220
بعبدا,فالوغا ,المدرسة الرسمية - غرفة رقم 5,مسيحي,519,220,3,1,217
بعبدا,قبيع ,المدرسة الرسمية - غرفة رقم 1,درزي,452,276,0,0,276
بعبدا,قبيع ,المدرسة الرسمية - غرفة رقم 2,مختلف,451,236,1,2,235
بعبدا,قبيع ,المدرسة الرسمية - غرفة رقم 3,درزي,516,289,2,3,287
بعبدا,قبيع ,المدرسة الرسمية - غرفة رقم 4,مختلف,472,232,2,1,230
بعبدا,قتاله ,صالون الكنيسة - غرفة رقم 1,مسيحي,204,93,5,0,88
بعبدا,قرطاضة ,كنيسة البلدة - غرفة رقم 1,ماروني,306,202,3,2,199
بعبدا,قرنايل ,المدرسة الرسمية - غرفة رقم 1,درزي,485,234,7,2,227
بعبدا,قرنايل ,المدرسة الرسمية - غرفة رقم 2,درزي,522,284,5,0,279
بعبدا,قرنايل ,المدرسة الرسمية - غرفة رقم 3,مختلف,516,285,5,1,280
بعبدا,قرنايل ,المدرسة الرسمية - غرفة رقم 4,درزي,509,243,4,1,239
بعبدا,قرنايل ,المدرسة الرسمية - غرفة رقم 5,درزي,509,253,3,1,250
بعبدا,قرنايل ,المدرسة الرسمية - غرفة رقم 6,مختلف,537,270,10,3,260
بعبدا,كفرسلوان ,ثانوية راهبات القلبين الاقدسين - غرفة رقم 1,درزي,495,283,5,1,278
بعبدا,كفرسلوان ,ثانوية راهبات القلبين الاقدسين - غرفة رقم 2,درزي,506,296,8,2,288
بعبدا,كفرسلوان ,ثانوية راهبات القلبين الاقدسين - غرفة رقم 3,مختلف,474,208,2,2,206
بعبدا,كفرسلوان ,ثانوية راهبات القلبين الاقدسين - غرفة رقم 4,درزي,520,296,9,0,287
بعبدا,كفرسلوان ,ثانوية راهبات القلبين الاقدسين - غرفة رقم 5,درزي,512,267,2,1,265
بعبدا,كفرسلوان ,ثانوية راهبات القلبين الاقدسين - غرفة رقم 6,مختلف,497,214,7,1,207
بعبدا,كفرشيما ,المدرسة الرسمية – دير قرقفي - غرفة رقم 1,روم كاثوليك,546,287,5,7,282
بعبدا,كفرشيما ,المدرسة الرسمية – دير قرقفي - غرفة رقم 2,ماروني,556,291,8,4,283
بعبدا,كفرشيما ,المدرسة الرسمية – دير قرقفي - غرفة رقم 3,مسيحي,545,215,4,0,211
بعبدا,كفرشيما ,المدرسة الرسمية – دير قرقفي - غرفة رقم 4,روم كاثوليك,530,256,2,3,254
بعبدا,كفرشيما ,المدرسة الرسمية – دير قرقفي - غرفة رقم 5,ماروني,542,284,0,0,284
بعبدا,كفرشيما ,المدرسة الرسمية – دير قرقفي - غرفة رقم 6,مسيحي,552,221,1,1,220
بعبدا,كفرشيما ,المدرسة الرسمية – دير قرقفي - غرفة رقم 7,روم ارثوذكس,572,287,2,0,285
بعبدا,كفرشيما ,المدرسة الرسمية – دير قرقفي - غرفة رقم 8,مسيحي,540,239,1,0,238
بعبدا,وادي شحرور السفلى ,صالون كنيسة مار يوحنا - غرفة رقم 1,ماروني,547,289,6,2,283
بعبدا,وادي شحرور السفلى ,صالون كنيسة مار يوحنا - غرفة رقم 2,ماروني,485,170,1,1,169
بعبدا,وادي شحرور السفلى ,صالون كنيسة مار يوحنا - غرفة رقم 3,ماروني,565,294,3,1,291
بعبدا,وادي شحرور السفلى ,صالون كنيسة مار يوحنا - غرفة رقم 4,ماروني,559,226,6,2,220
بعبدا,وادي شحرور العليا ,مبنى البلدية - غرفة رقم 1,روم ارثوذكس,537,296,0,0,296
بعبدا,وادي شحرور العليا ,مبنى البلدية - غرفة رقم 2,ماروني,489,282,8,4,274
بعبدا,وادي شحرور العليا ,مبنى البلدية - غرفة رقم 3,روم ارثوذكس,530,319,4,2,315
بعبدا,وادي شحرور العليا ,مبنى البلدية - غرفة رقم 4,روم ارثوذكس,512,218,7,0,211
بعبدا,وادي شحرور العليا ,مبنى البلدية - غرفة رقم 5,ماروني,500,296,6,1,290
بعلبك,الانصار ,مدرسة الانصار الرسمية - غرفة رقم 1,شيعي,261,234,1,5,233
بعلبك,البرانيه حي المسيحيين ,ثانوية خليل مطران (معهد العلوم التطبيقية سابقاً) - غرفة رقم 1,مختلف,406,73,1,0,72
بعلبك,البرانيه حي المسيحيين ,ثانوية خليل مطران (معهد العلوم التطبيقية سابقاً) - غرفة رقم 2,مختلف,428,70,0,0,70
بعلبك,البرباره محلة المسيحيين ,ثانوية خليل مطران (معهد العلوم التطبيقية سابقاً) - غرفة رقم 3,روم كاثوليك,399,84,0,0,84
بعلبك,البرباره محلة المسيحيين ,ثانوية خليل مطران (معهد العلوم التطبيقية سابقاً) - غرفة رقم 4,روم كاثوليك,390,80,2,0,78
بعلبك,التوفيقيه ,المدرسة الرسمية - غرفة رقم 1,شيعي,668,468,0,0,468
بعلبك,التوفيقيه ,المدرسة الرسمية - غرفة رقم 2,شيعي,658,563,9,1,554
بعلبك,التوفيقيه ,المدرسة الرسمية - غرفة رقم 3,مسلم,590,475,0,0,475
بعلبك,الجديده ,المدرسة الرسمية - غرفة رقم 1,روم كاثوليك,572,248,5,0,243
بعلبك,الجديده ,المدرسة الرسمية - غرفة رقم 2,مختلف,584,282,0,2,282
بعلبك,الجديده ,المدرسة الرسمية - غرفة رقم 3,روم كاثوليك,570,265,2,1,263
بعلبك,الجديده ,المدرسة الرسمية - غرفة رقم 4,مختلف,577,302,17,1,285
بعلبك,الجوبانية ,المدرسة الرسمية - غرفة رقم 1,شيعي,289,242,1,0,241
بعلبك,الحدث الشمالي ,المدرسة المتوسطة الرسمية - غرفة رقم 1,مسيحي,441,156,3,2,153
بعلبك,الحدث الشمالي ,المدرسة المتوسطة الرسمية - غرفة رقم 2,مسيحي,459,161,1,1,160
بعلبك,الحدث الغربي ,المدرسة المتوسطة الرسمية - غرفة رقم 3,شيعي,554,312,2,2,310
بعلبك,الحدث الغربي ,المدرسة المتوسطة الرسمية - غرفة رقم 4,شيعي,547,317,2,3,315
بعلبك,الحدث الغربي ,المدرسة المتوسطة الرسمية - غرفة رقم 5,شيعي,549,363,3,2,360
بعلبك,الحدث الغربي ,المدرسة المتوسطة الرسمية - غرفة رقم 6,شيعي,554,423,10,8,413
بعلبك,الحلانيه ,المدرسة الرسمية - غرفة رقم 1,شيعي,197,160,1,0,159
بعلبك,الخريبه ,المدرسة الرسمية - غرفة رقم 1,شيعي,544,345,8,1,337
بعلبك,الخريبه ,المدرسة الرسمية - غرفة رقم 2,شيعي,560,404,7,2,397
بعلبك,الخريبه ,المدرسة الرسمية - غرفة رقم 3,شيعي,543,363,11,0,352
بعلبك,الخريبه حي الجامع ,المدرسة الرسمية - غرفة رقم 4,شيعي,119,99,0,1,99
بعلبك,الخضر الشرقي ,حسينية اهل البيت - غرفة رقم 1,شيعي,398,220,0,0,220
بعلبك,الخضر الشرقي ,حسينية اهل البيت - غرفة رقم 2,شيعي,391,316,1,1,315
بعلبك,الخضر الغربي ,المدرسة الرسمية غربي - غرفة رقم 1,شيعي,505,302,16,0,286
بعلبك,الخضر الغربي ,المدرسة الرسمية غربي - غرفة رقم 2,شيعي,476,380,5,1,375
بعلبك,الخضر الغربي ,المدرسة الرسمية غربي - غرفة رقم 3,مسلم,505,369,10,2,359
بعلبك,الخضر حي الاشعل ,حسينية الامام الحسن - غرفة رقم 1,شيعي,116,85,0,0,85
بعلبك,الخضر حي الجنوبي ,حسينية اهل البيت - غرفة رقم 3,شيعي,61,52,1,0,51
بعلبك,الخضر حي الشعب ,حسينية اهل البيت - غرفة رقم 4,شيعي,94,74,1,0,73
بعلبك,الرام ,المدرسة الرسمية - غرفة رقم 1,شيعي,503,304,0,0,304
بعلبك,الرام ,المدرسة الرسمية - غرفة رقم 2,شيعي,591,414,2,3,412
بعلبك,الريش حي الشرقي ,مدرسة بعلبك الابتدائية المختلطة الرسمية (تجمع المدارس) - غرفة رقم 1,شيعي,620,315,4,1,311
بعلبك,الريش حي الشرقي ,مدرسة بعلبك الابتدائية المختلطة الرسمية (تجمع المدارس) - غرفة رقم 2,شيعي,620,353,5,0,348
بعلبك,الريش حي الشرقي ,مدرسة بعلبك الابتدائية المختلطة الرسمية (تجمع المدارس) - غرفة رقم 3,شيعي,604,349,23,2,326
بعلبك,الريش حي الشرقي ,مدرسة بعلبك الابتدائية المختلطة الرسمية (تجمع المدارس) - غرفة رقم 4,شيعي,604,330,0,3,330
بعلبك,الريش حي الشرقي ,مدرسة بعلبك الابتدائية المختلطة الرسمية (تجمع المدارس) - غرفة رقم 5,مختلف,588,324,10,4,314
بعلبك,الريش حي الشرقي ,مدرسة بعلبك الابتدائية المختلطة الرسمية (تجمع المدارس) - غرفة رقم 6,شيعي,546,288,1,1,287
بعلبك,الريش حي الشرقي ,مدرسة بعلبك الابتدائية المختلطة الرسمية (تجمع المدارس) - غرفة رقم 7,مسلم,650,326,14,2,312
بعلبك,الريش حي الشرقي ,مدرسة بعلبك المختلطة الرسمية (تجمع المدارس) - غرفة رقم 1,شيعي,601,298,5,3,293
بعلبك,الريش حي الشرقي ,مدرسة بعلبك المختلطة الرسمية (تجمع المدارس) - غرفة رقم 2,شيعي,603,353,10,0,343
بعلبك,الريش حي الشرقي ,مدرسة بعلبك المختلطة الرسمية (تجمع المدارس) - غرفة رقم 3,شيعي,605,304,3,2,301
بعلبك,الريش حي الشرقي ,مدرسة بعلبك المختلطة الرسمية (تجمع المدارس) - غرفة رقم 4,شيعي,635,347,8,1,339
بعلبك,الريش حي الشرقي ,مدرسة بعلبك المختلطة الرسمية (تجمع المدارس) - غرفة رقم 5,شيعي,606,310,3,1,307
بعلبك,الريش حي الشرقي ,مدرسة بعلبك المختلطة الرسمية (تجمع المدارس) - غرفة رقم 6,مختلف,595,305,6,0,299
بعلبك,الريش حي الشميس ,مدرسة بعلبك المتوسطة المختلطة الرسمية (تجمع المدارس) - غرفة رقم 1,مسلم,373,220,0,0,220
بعلبك,الريش حي الشميس ,مدرسة بعلبك المتوسطة المختلطة الرسمية (تجمع المدارس) - غرفة رقم 2,شيعي,408,250,9,0,241
بعلبك,الريش حي الغربي ,مدرسة بعلبك المتوسطة المختلطة الرسمية (تجمع المدارس) - غرفة رقم 3,شيعي,608,306,8,2,298
بعلبك,الريش حي الغربي ,مدرسة بعلبك المتوسطة المختلطة الرسمية (تجمع المدارس) - غرفة رقم 4,شيعي,617,354,11,1,343
بعلبك,الريش حي الغربي ,مدرسة بعلبك المتوسطة المختلطة الرسمية (تجمع المدارس) - غرفة رقم 5,شيعي,625,342,11,1,331
بعلبك,الريش حي الغربي ,مدرسة بعلبك المتوسطة المختلطة الرسمية (تجمع المدارس) - غرفة رقم 6,شيعي,634,326,0,1,326
بعلبك,الريش حي الغربي ,مدرسة بعلبك المتوسطة المختلطة الرسمية (تجمع المدارس) - غرفة رقم 7,شيعي,618,366,5,2,361
بعلبك,الريش حي الغربي ,مدرسة بعلبك المتوسطة المختلطة الرسمية (تجمع المدارس) - غرفة رقم 8,شيعي,602,363,2,1,361
بعلبك,الريش حي الغربي ,مدرسة بعلبك المتوسطة المختلطة الرسمية (تجمع المدارس) - غرفة رقم 9,مسلم,624,353,2,2,351
بعلبك,الزرازير ,المدرسة الرسمية - غرفة رقم 1,ماروني,531,342,4,2,338
بعلبك,الزرازير ,المدرسة الرسمية - غرفة رقم 2,ماروني,533,394,9,5,385
بعلبك,السعيده ,المدرسة الرسمية - غرفة رقم 1,مختلف,441,239,4,8,235
بعلبك,السعيده ,المدرسة الرسمية - غرفة رقم 2,مختلف,465,287,1,2,286
بعلبك,السفري ,حسينية البلدة - غرفة رقم 1,مسلم,402,294,2,0,292
بعلبك,الصوانية ,المدرسة الرسمية - غرفة رقم 1,شيعي,572,380,1,0,379
بعلبك,الطيبه ,دار البلدية - غرفة رقم 1,مختلف,384,115,0,1,115
بعلبك,الطيبه ,دار البلدية - غرفة رقم 2,مختلف,393,106,2,1,104
بعلبك,العقيدية ,النادي الحسيني - غرفة رقم 1,شيعي,430,281,0,0,281
بعلبك,العلاق ,حسينية البلدة - غرفة رقم 1,شيعي,508,302,2,1,300
بعلبك,العلاق ,حسينية البلدة - غرفة رقم 2,شيعي,535,347,3,2,344
بعلبك,العين ,التكميلية الرسمية - غرفة رقم 1,سني,695,388,14,1,374
بعلبك,العين ,التكميلية الرسمية - غرفة رقم 2,سني,688,356,16,0,340
بعلبك,العين ,التكميلية الرسمية - غرفة رقم 3,سني,709,377,13,3,364
بعلبك,العين ,التكميلية الرسمية - غرفة رقم 4,سني,697,375,30,0,345
بعلبك,العين ,المدرسة النموذجية - غرفة رقم 1,شيعي,617,397,14,2,383
بعلبك,العين ,المدرسة النموذجية - غرفة رقم 2,شيعي,643,378,16,4,362
بعلبك,العين ,المدرسة النموذجية - غرفة رقم 3,شيعي,611,369,8,3,361
بعلبك,العين ,المدرسة النموذجية - غرفة رقم 4,شيعي,635,400,8,0,392
بعلبك,العين ,المدرسة النموذجية - غرفة رقم 5,شيعي,616,391,15,2,376
بعلبك,العين ,المدرسة النموذجية - غرفة رقم 6,شيعي,622,412,13,3,399
بعلبك,العين ,المدرسة النموذجية - غرفة رقم 7,مختلف,619,315,14,1,301
بعلبك,الفاكهة حي الجامع ,المدرسة الرسمية - غرفة رقم 1,سني,605,278,2,3,276
بعلبك,الفاكهة حي الجامع ,المدرسة الرسمية - غرفة رقم 2,سني,603,278,9,0,269
بعلبك,الفاكهة حي الجامع ,المدرسة الرسمية - غرفة رقم 3,سني,568,298,8,3,290
بعلبك,الفاكهة حي الجامع ,المدرسة الرسمية - غرفة رقم 4,سني,627,326,31,2,295
بعلبك,الفاكهة حي الجامع ,المدرسة الرسمية - غرفة رقم 5,سني,613,330,2,2,328
بعلبك,الفاكهة حي الجامع ,المدرسة الرسمية - غرفة رقم 6,سني,625,327,13,5,314
بعلبك,الفاكهة حي مار جرجس ,مدرسة راهبات القلبين الاقدسين المبنى الجديد - غرفة رقم 1,روم كاثوليك,533,183,1,2,182
بعلبك,الفاكهة حي مار جرجس ,مدرسة راهبات القلبين الاقدسين المبنى الجديد - غرفة رقم 2,روم كاثوليك,528,195,1,2,194
بعلبك,الفاكهة حي مار جرجس ,مدرسة راهبات القلبين الاقدسين المبنى الجديد - غرفة رقم 3,مسيحي,481,148,1,1,147
بعلبك,القاع ,المدرسة الابتدائية الرسمية - غرفة رقم 1,روم كاثوليك,604,341,10,4,331
بعلبك,القاع ,المدرسة الابتدائية الرسمية - غرفة رقم 2,روم كاثوليك,611,357,2,5,355
بعلبك,القاع ,المدرسة الابتدائية الرسمية - غرفة رقم 3,روم كاثوليك,592,324,9,1,315
بعلبك,القاع ,المدرسة الابتدائية الرسمية - غرفة رقم 4,روم كاثوليك,610,346,11,1,335
بعلبك,القاع ,المدرسة الابتدائية الرسمية - غرفة رقم 5,روم كاثوليك,599,312,15,2,297
بعلبك,القاع ,المدرسة المتوسطة الرسمية - غرفة رقم 1,روم كاثوليك,571,296,6,0,290
بعلبك,القاع ,المدرسة المتوسطة الرسمية - غرفة رقم 2,روم كاثوليك,568,298,16,0,282
بعلبك,القاع ,المدرسة المتوسطة الرسمية - غرفة رقم 3,روم كاثوليك,587,291,7,0,284
بعلبك,القاع ,المدرسة المتوسطة الرسمية - غرفة رقم 4,روم كاثوليك,580,281,5,0,276
بعلبك,القاع ,المدرسة المتوسطة الرسمية - غرفة رقم 5,روم كاثوليك,535,271,10,0,261
بعلبك,القاع ,المدرسة المتوسطة الرسمية - غرفة رقم 6,مسيحي,565,287,6,4,281
بعلبك,القدام ,مركز البلدية حاليا (المدرسة الرسمية) - غرفة رقم 1,ماروني,481,291,1,1,290
بعلبك,القدام ,مركز البلدية حاليا (المدرسة الرسمية) - غرفة رقم 2,ماروني,468,290,1,1,289
بعلبك,القدام ,مركز البلدية حاليا (المدرسة الرسمية) - غرفة رقم 3,مختلف,479,295,2,1,293
بعلبك,الكنيسه ,بهو الجامع - غرفة رقم 1,شيعي,565,361,1,0,360
بعلبك,الكنيسه ,بهو الجامع - غرفة رقم 2,شيعي,341,341,1,1,340
بعلبك,الكنيسه ,بهو الجامع - غرفة رقم 3,شيعي,546,341,0,0,341
بعلبك,الكنيسه ,حسينية البلدة - غرفة رقم 1,شيعي,335,319,3,1,316
بعلبك,الكنيسه ,حسينية البلدة - غرفة رقم 2,شيعي,550,382,0,0,382
بعلبك,اللبوة ,التكميلية الرسمية - غرفة رقم 1,شيعي,580,339,3,0,336
بعلبك,اللبوة ,التكميلية الرسمية - غرفة رقم 2,شيعي,566,345,21,2,324
بعلبك,اللبوة ,التكميلية الرسمية - غرفة رقم 3,شيعي,574,345,2,1,343
بعلبك,اللبوة ,التكميلية الرسمية - غرفة رقم 4,شيعي,579,366,14,3,352
بعلبك,اللبوة ,التكميلية الرسمية - غرفة رقم 5,مسلم,560,376,1,0,375
بعلبك,اللبوة ,الثانوية الرسمية - غرفة رقم 1,شيعي,634,373,6,2,367
بعلبك,اللبوة ,الثانوية الرسمية - غرفة رقم 2,شيعي,660,410,12,0,398
بعلبك,اللبوة ,الثانوية الرسمية - غرفة رقم 3,شيعي,635,355,6,1,349
بعلبك,اللبوة ,الثانوية الرسمية - غرفة رقم 4,شيعي,683,415,14,0,401
بعلبك,النبي رشاده ,المدرسة الرسمية - غرفة رقم 1,شيعي,516,266,4,1,262
بعلبك,النبي رشاده ,المدرسة الرسمية - غرفة رقم 2,شيعي,490,278,5,0,273
بعلبك,النبي رشاده ,المدرسة الرسمية - غرفة رقم 3,شيعي,486,281,3,1,278
بعلبك,النبي سباط ,مدرسة بعلبك الرسمية الجديدة الاولى - غرفة رقم 12,شيعي,209,135,0,0,135
بعلبك,النبي شيت حي الجامع ,النادي الحسيني حي الشرقي - غرفة رقم 5,شيعي,266,196,1,0,195
بعلبك,النبي شيت حي الجنوبي ,النادي الحسيني في الحي الشرقي - غرفة رقم 1,شيعي,364,252,0,0,252
بعلبك,النبي شيت حي الشرقي ,النادي الحسيني حي شرقي - غرفة رقم 4,مسلم,635,428,12,2,416
بعلبك,النبي شيت حي الشمالي ,النادي الحسيني في الحي الشرقي - غرفة رقم 2,شيعي,699,515,2,1,513
بعلبك,النبي شيت حي العريض ,النادي الحسيني حي الشرقي - غرفة رقم 3,مسلم,558,351,6,0,345
بعلبك,النبي شيت حي العقبة ,النادي الحسيني في حي العقبة - غرفة رقم 1,شيعي,493,371,1,0,370
بعلبك,النبي شيت حي الغربي ,التكميلية الرسمية - غرفة رقم 1,شيعي,616,456,0,2,456
بعلبك,النبي شيت حي الغربي ,التكميلية الرسمية - غرفة رقم 2,شيعي,635,508,1,2,507
بعلبك,النبي شيت حي الغربي ,التكميلية الرسمية - غرفة رقم 3,شيعي,634,495,5,1,490
بعلبك,النبي شيت حي الغربي ,الثانوية الرسمية - غرفة رقم 1,شيعي,642,441,4,8,437
بعلبك,النبي شيت حي الغربي ,الثانوية الرسمية - غرفة رقم 2,شيعي,647,436,1,0,435
بعلبك,النبي شيت حي الغربي ,الثانوية الرسمية - غرفة رقم 3,شيعي,636,503,7,1,496
بعلبك,النبي شيت حي الغربي ,الثانوية الرسمية - غرفة رقم 4,مسلم,644,457,4,5,453
بعلبك,النبي شيت حي طبشار ,النادي الحسيني طبشار - غرفة رقم 1,شيعي,217,183,1,0,182
بعلبك,النبي عثمان ,المدرسة الرسمية - غرفة رقم 1,شيعي,635,390,1,0,389
بعلبك,النبي عثمان ,المدرسة الرسمية - غرفة رقم 2,شيعي,374,374,3,1,371
بعلبك,النبي عثمان ,المدرسة الرسمية - غرفة رقم 3,شيعي,653,437,14,2,423
بعلبك,النبي عثمان ,المدرسة الرسمية - غرفة رقم 4,شيعي,682,462,8,0,454
بعلبك,النبي عثمان ,بيت جاهز قرب منزل السيد عباس قاسم سيف الدين - غرفة رقم 1,شيعي,381,260,2,1,258
بعلبك,النبي نعام ,مدرسة بعلبك الرسمية الجديدة الأولى - غرفة رقم 1,شيعي,638,354,10,4,344
بعلبك,النبي نعام ,مدرسة بعلبك الرسمية الجديدة الأولى - غرفة رقم 10,شيعي,647,428,10,4,418
بعلبك,النبي نعام ,مدرسة بعلبك الرسمية الجديدة الأولى - غرفة رقم 11,شيعي,674,447,2,2,445
بعلبك,النبي نعام ,مدرسة بعلبك الرسمية الجديدة الأولى - غرفة رقم 2,شيعي,603,377,14,3,363
بعلبك,النبي نعام ,مدرسة بعلبك الرسمية الجديدة الأولى - غرفة رقم 3,شيعي,633,343,11,4,332
بعلبك,النبي نعام ,مدرسة بعلبك الرسمية الجديدة الأولى - غرفة رقم 4,شيعي,637,364,13,0,351
بعلبك,النبي نعام ,مدرسة بعلبك الرسمية الجديدة الأولى - غرفة رقم 5,شيعي,628,391,6,0,385
بعلبك,النبي نعام ,مدرسة بعلبك الرسمية الجديدة الأولى - غرفة رقم 6,شيعي,614,369,11,0,358
بعلبك,النبي نعام ,مدرسة بعلبك الرسمية الجديدة الأولى - غرفة رقم 7,شيعي,606,393,10,1,383
بعلبك,النبي نعام ,مدرسة بعلبك الرسمية الجديدة الأولى - غرفة رقم 8,شيعي,632,373,1,1,372
بعلبك,النبي نعام ,مدرسة بعلبك الرسمية الجديدة الأولى - غرفة رقم 9,شيعي,650,381,1,1,380
بعلبك,النقرة ,حسينية قرية النقرة - غرفة رقم 1,شيعي,155,126,0,0,126
بعلبك,اليمونه ,المدرسة الرسمية - غرفة رقم 1,شيعي,663,438,0,0,438
بعلبك,اليمونه ,المدرسة الرسمية - غرفة رقم 2,شيعي,607,470,1,0,469
بعلبك,اليمونه ,المدرسة الرسمية - غرفة رقم 3,مختلف,639,458,0,0,458
بعلبك,ايعات ,متوسطة ايعات الرسمية - غرفة رقم 1,شيعي,609,322,7,0,315
بعلبك,ايعات ,متوسطة ايعات الرسمية - غرفة رقم 2,شيعي,611,331,6,1,325
بعلبك,ايعات ,متوسطة ايعات الرسمية - غرفة رقم 3,مختلف,601,328,2,1,326
بعلبك,ايعات ,متوسطة ايعات الرسمية - غرفة رقم 4,شيعي,622,376,0,0,376
بعلبك,ايعات ,متوسطة ايعات الرسمية - غرفة رقم 5,شيعي,594,367,2,0,365
بعلبك,ايعات ,متوسطة ايعات الرسمية - غرفة رقم 6,مختلف,589,371,5,2,366
بعلبك,ايعات ,متوسطة ايعات الرسمية - غرفة رقم 7,مختلف,588,253,2,1,251
بعلبك,بتدعي ,المدرسة الرسمية (مبنى وقف مار نهرا) - غرفة رقم 1,ماروني,614,399,3,4,396
بعلبك,بدنايل ,ثانوية بدنايل - غرفة رقم 1,شيعي,618,344,4,0,340
بعلبك,بدنايل ,ثانوية بدنايل - غرفة رقم 2,شيعي,581,323,4,3,319
بعلبك,بدنايل ,ثانوية بدنايل - غرفة رقم 3,شيعي,621,342,6,2,336
بعلبك,بدنايل ,ثانوية بدنايل - غرفة رقم 4,شيعي,613,352,10,4,342
بعلبك,بدنايل ,متوسطة بدنايل الرسمية (المعروفة باسم متوسطة سليم حيدر الرسمية) - غرفة رقم 1,مسلم,589,336,29,2,307
بعلبك,بدنايل ,متوسطة بدنايل الرسمية (المعروفة باسم متوسطة سليم حيدر الرسمية) - غرفة رقم 2,شيعي,652,408,7,1,401
بعلبك,بدنايل ,متوسطة بدنايل الرسمية (المعروفة باسم متوسطة سليم حيدر الرسمية) - غرفة رقم 3,شيعي,638,416,4,0,412
بعلبك,بدنايل ,متوسطة بدنايل الرسمية (المعروفة باسم متوسطة سليم حيدر الرسمية) - غرفة رقم 4,شيعي,640,416,1,1,415
بعلبك,بدنايل ,متوسطة بدنايل الرسمية (المعروفة باسم متوسطة سليم حيدر الرسمية) - غرفة رقم 5,شيعي,622,356,1,1,355
بعلبك,بدنايل ,متوسطة بدنايل الرسمية (المعروفة باسم متوسطة سليم حيدر الرسمية) - غرفة رقم 6,مسلم,624,380,15,5,365
بعلبك,برقه ,المدرسة الرسمية - غرفة رقم 1,ماروني,462,342,0,0,342
بعلبك,برقه ,المدرسة الرسمية - غرفة رقم 2,ماروني,468,383,2,0,381
بعلبك,بريتال اليونسية ,مدرسة الحجه - غرفة رقم 1,شيعي,693,430,0,0,430
بعلبك,بريتال اليونسية ,مدرسة الحجه - غرفة رقم 2,شيعي,724,482,25,1,457
بعلبك,بريتال حي التين ,المدرسة الخاصة للسيد علي ابراهيم - غرفة رقم 4,شيعي,387,254,3,3,251
بعلبك,بريتال شرقي ,المدرسة الرسمية الأولى - غرفة رقم 1,شيعي,632,342,8,4,334
بعلبك,بريتال شرقي ,المدرسة الرسمية الأولى - غرفة رقم 2,مسلم,651,338,3,2,335
بعلبك,بريتال شرقي ,المدرسة الرسمية الأولى - غرفة رقم 3,شيعي,677,410,8,0,402
بعلبك,بريتال شرقي ,المدرسة الرسمية الأولى - غرفة رقم 4,مسلم,670,400,11,4,389
بعلبك,بريتال شميس ,المدرسة الخاصة للسيد علي ابراهيم - غرفة رقم 1,شيعي,503,310,14,3,296
بعلبك,بريتال شميس ,المدرسة الخاصة للسيد علي ابراهيم - غرفة رقم 2,شيعي,492,355,9,3,346
بعلبك,بريتال شميس ,المدرسة الخاصة للسيد علي ابراهيم - غرفة رقم 3,شيعي,533,318,2,1,316
بعلبك,بريتال شميس غربي ,المدرســة الرسميـــة الثانية - غرفة رقم 1,شيعي,468,261,11,1,250
بعلبك,بريتال شميس غربي ,المدرســة الرسميـــة الثانية - غرفة رقم 2,شيعي,436,299,9,2,290
بعلبك,بريتال عين البنيه ,المدرسة الرسمية الأولى - غرفة رقم 5,شيعي,235,180,3,2,177
بعلبك,بريتال عين الجوز ,المدرسة الرسمية الأولى - غرفة رقم 6,شيعي,164,117,3,0,114
بعلبك,بريتال غربي ,الثانوية الرسمية - غرفة رقم 1,شيعي,613,387,2,1,385
بعلبك,بريتال غربي ,الثانوية الرسمية - غرفة رقم 2,شيعي,591,405,2,0,403
بعلبك,بريتال غربي ,الثانوية الرسمية - غرفة رقم 3,شيعي,645,434,27,3,407
بعلبك,بريتال غربي ,الثانوية الرسمية - غرفة رقم 4,شيعي,621,411,26,4,385
بعلبك,بشوات ,المدرسة الرسمية في بشوات - غرفة رقم 1,ماروني,364,175,0,1,175
بعلبك,بشوات ,المدرسة الرسمية في بشوات - غرفة رقم 2,ماروني,378,215,0,0,215
بعلبك,بعلبك موظفون ,سراي الهرمل - غرفة رقم 1,مختلف,261,234,1,5,233
بعلبك,بعلبك موظفون ,سراي بعلبك - غرفة رقم 1,مختلف,429,369,6,6,363
بعلبك,بعلبك موظفون ,سراي بعلبك - غرفة رقم 2,مختلف,437,394,9,3,385
بعلبك,بعلبك موظفون ,سراي بعلبك - غرفة رقم 3,مختلف,440,381,0,2,381
بعلبك,بعلبك موظفون ,سراي بعلبك - غرفة رقم 4,مختلف,441,400,1,4,399
بعلبك,بوداي ,المدرسة الرسمية في بلدة بوداي - غرفة رقم 1,شيعي,621,391,16,1,375
بعلبك,بوداي ,المدرسة الرسمية في بلدة بوداي - غرفة رقم 2,شيعي,608,397,2,4,395
بعلبك,بوداي ,المدرسة الرسمية في بلدة بوداي - غرفة رقم 3,شيعي,616,409,3,0,406
بعلبك,بوداي ,المدرسة الرسمية في بلدة بوداي - غرفة رقم 4,شيعي,625,451,9,0,442
بعلبك,بوداي ,المدرسة الرسمية في بلدة بوداي - غرفة رقم 5,شيعي,649,422,16,1,406
بعلبك,بوداي ,المدرسة الرسمية في بلدة بوداي - غرفة رقم 6,شيعي,610,424,13,2,411
بعلبك,بوداي ,حسينية الزعرورية في بلدة بوداي - غرفة رقم 1,شيعي,660,414,5,0,409
بعلبك,بوداي ,حسينية الزعرورية في بلدة بوداي - غرفة رقم 2,شيعي,624,390,18,3,372
بعلبك,بوداي ,حسينية الزعرورية في بلدة بوداي - غرفة رقم 3,شيعي,619,408,0,4,408
بعلبك,بيت ابو صليبي ,المدرسة الرسمية - غرفة رقم 1,شيعي,710,515,1,3,514
بعلبك,بيت شاما ,المدرسة الرسمية - غرفة رقم 1,شيعي,522,261,0,1,261
بعلبك,بيت شاما ,المدرسة الرسمية - غرفة رقم 2,شيعي,498,313,9,3,304
بعلبك,بيت شاما ,المدرسة الرسمية - غرفة رقم 3,مختلف,479,213,5,1,208
بعلبك,بيت مشيك ,المدرسة الرسمية (مدرسة وادي ام علي) - غرفة رقم 1,مسلم,677,393,4,1,389
بعلبك,بيت مشيك ,المدرسة الرسمية (مدرسة وادي ام علي) - غرفة رقم 2,مسلم,691,458,2,1,456
بعلبك,تمنين التحتا ,متوسطة تمنين التحتا الرسمية - غرفة رقم 1,شيعي,562,344,8,1,336
بعلبك,تمنين التحتا ,متوسطة تمنين التحتا الرسمية - غرفة رقم 2,شيعي,601,353,0,0,353
بعلبك,تمنين التحتا ,متوسطة تمنين التحتا الرسمية - غرفة رقم 3,شيعي,581,344,0,1,344
بعلبك,تمنين التحتا ,متوسطة تمنين التحتا الرسمية - غرفة رقم 4,شيعي,581,330,1,0,329
بعلبك,تمنين التحتا ,متوسطة تمنين التحتا الرسمية - غرفة رقم 5,شيعي,575,418,0,1,418
بعلبك,تمنين التحتا ,متوسطة تمنين التحتا الرسمية - غرفة رقم 6,شيعي,592,419,4,1,415
بعلبك,تمنين التحتا ,متوسطة تمنين التحتا الرسمية - غرفة رقم 7,شيعي,584,448,0,0,448
بعلبك,تمنين التحتا ,متوسطة تمنين التحتا الرسمية - غرفة رقم 8,شيعي,570,379,1,0,378
بعلبك,تمنين التحتا ,متوسطة تمنين التحتا الرسمية - غرفة رقم 9,شيعي,635,417,5,2,412
بعلبك,تمنين الفوقا ,المدرسة المتوسطة الرسمية - غرفة رقم 1,شيعي,616,338,1,0,337
بعلبك,تمنين الفوقا ,المدرسة المتوسطة الرسمية - غرفة رقم 2,شيعي,633,479,1,0,478
بعلبك,تمنين الفوقا ,المدرسة المتوسطة الرسمية - غرفة رقم 3,شيعي,584,443,0,0,443
بعلبك,تمنين الفوقا ,النادي الحسيني - غرفة رقم 1,شيعي,616,373,2,0,371
بعلبك,جبعا ,المدرسة الرسمية - غرفة رقم 1,شيعي,340,262,3,0,259
بعلبك,جبوله ,مدرسة راهبات دير جبولة - غرفة رقم 1,مسلم,415,226,23,3,203
بعلبك,جبوله ,مدرسة راهبات دير جبولة - غرفة رقم 2,مسلم,429,244,5,1,239
بعلبك,جنتا ,المدرسة الرسمية - غرفة رقم 1,شيعي,457,268,0,2,268
بعلبك,جنتا ,المدرسة الرسمية - غرفة رقم 2,شيعي,476,372,5,1,367
بعلبك,حام ,المدرسة الرسمية - غرفة رقم 1,شيعي,579,352,9,1,343
بعلبك,حربتا ,المدرسة الرسمية - غرفة رقم 1,شيعي,547,300,0,1,300
بعلبك,حربتا ,المدرسة الرسمية - غرفة رقم 2,شيعي,568,299,12,1,287
بعلبك,حربتا ,المدرسة الرسمية - غرفة رقم 3,مسلم,560,322,6,1,316
بعلبك,حربتا ,المدرسة الرسمية - غرفة رقم 4,شيعي,579,351,0,0,351
بعلبك,حربتا ,المدرسة الرسمية - غرفة رقم 5,شيعي,572,383,5,0,378
بعلبك,حربتا ,المدرسة الرسمية - غرفة رقم 6,مسلم,574,356,1,0,355
بعلبك,حزين ,المدرسة الرسمية - غرفة رقم 1,شيعي,576,348,4,1,344
بعلبك,حزين ,المدرسة الرسمية - غرفة رقم 2,شيعي,594,442,1,1,441
بعلبك,حلبتا ,المدرسة الرسمية - غرفة رقم 1,شيعي,692,511,8,0,503
بعلبك,حلبتا ,المدرسة الرسمية - غرفة رقم 2,شيعي,705,531,4,1,527
بعلبك,حور تعلا ,المدرسة الرسمية - غرفة رقم 1,شيعي,536,276,4,1,272
بعلبك,حور تعلا ,المدرسة الرسمية - غرفة رقم 2,مسلم,538,286,6,2,280
بعلبك,حور تعلا ,المدرسة الرسمية - غرفة رقم 3,شيعي,525,309,18,1,291
بعلبك,حور تعلا ,المدرسة الرسمية - غرفة رقم 4,مسلم,510,304,5,1,299
بعلبك,حور تعلا ,المدرسة الرسمية - غرفة رقم 5,شيعي,526,279,6,0,273
بعلبك,حور تعلا حي الشعب ,المدرسة الرسمية - غرفة رقم 6,شيعي,223,151,3,1,148
بعلبك,حور تعلا حي الوادي ,المدرسة الرسمية - غرفة رقم 7,شيعي,164,117,4,0,113
بعلبك,حور تعلا حي حقل العرجة ,المدرسة الرسمية - غرفة رقم 8,شيعي,20,17,0,0,17
بعلبك,حوش الذهب ,المدرسة الرسمية في حوش تلصفيه - غرفة رقم 3,شيعي,93,61,2,1,59
بعلبك,حوش الرافقه ,المدرسة المتوسطة الرسمية - غرفة رقم 1,شيعي,625,376,1,0,375
بعلبك,حوش الرافقه ,المدرسة المتوسطة الرسمية - غرفة رقم 2,مسلم,639,386,7,3,379
بعلبك,حوش الرافقه ,المدرسة المتوسطة الرسمية - غرفة رقم 3,شيعي,665,494,1,0,493
بعلبك,حوش الرافقه ,المدرسة المتوسطة الرسمية - غرفة رقم 4,مسلم,670,475,1,0,474
بعلبك,حوش النبي ,المدرسة الرسمية - غرفة رقم 1,مسلم,400,255,1,2,254
بعلبك,حوش النبي ,المدرسة الرسمية - غرفة رقم 2,مسلم,411,283,8,4,275
بعلبك,حوش بردى ,دار البلدية - غرفة رقم 1,مختلف,324,123,0,1,123
بعلبك,حوش بردى ,دار البلدية - غرفة رقم 2,مختلف,325,103,1,1,102
بعلبك,حوش تل صفيه ,المدرسة الرسمية في حوش تلصفيه - غرفة رقم 1,مختلف,348,196,0,0,196
بعلبك,حوش تل صفيه ,المدرسة الرسمية في حوش تلصفيه - غرفة رقم 2,مختلف,346,221,1,0,220
بعلبك,حوش سنيد ,مركز بلدية حوش سنيد - غرفة رقم 1,شيعي,262,186,1,0,185
بعلبك,حي الست ,ثانوية خليل مطران (معهد العلوم التطبيقية سابقاً) - غرفة رقم 12,شيعي,43,37,0,0,37
بعلبك,حي الصلح ,معهد الابرار التقني - غرفة رقم 1,سني,635,382,1,0,381
بعلبك,حي الصلح ,معهد الابرار التقني - غرفة رقم 2,سني,627,350,4,1,346
بعلبك,حي الصلح ,معهد الابرار التقني - غرفة رقم 3,سني,636,413,33,0,380
بعلبك,حي الصلح ,معهد الابرار التقني - غرفة رقم 4,سني,645,465,12,0,453
بعلبك,حي الصلح ,معهد الابرار التقني - غرفة رقم 5,سني,583,334,6,2,328
بعلبك,حي العباسية ,مركز جمعية النهضة - غرفة رقم 1,مسلم,265,165,2,0,163
بعلبك,دار الواسعة ,مدرسة الشراونة الرسمية - غرفة رقم 1,شيعي,483,206,0,0,206
بعلبك,دورس حي البير ,مدرسة دورس الرسمية المشغولة من الجامعة اللبنانبة كلية العلوم الفرع الرابع شعبة بعلبك - غرفة رقم 1,مختلف,554,326,4,1,322
بعلبك,دورس حي البير ,مدرسة دورس الرسمية المشغولة من الجامعة اللبنانبة كلية العلوم الفرع الرابع شعبة بعلبك - غرفة رقم 2,مختلف,545,356,4,2,352
بعلبك,دورس حي البير ,مدرسة دورس الرسمية المشغولة من الجامعة اللبنانبة كلية العلوم الفرع الرابع شعبة بعلبك - غرفة رقم 3,سني,545,356,4,2,352
بعلبك,دورس حي السيدة ,مدرسة دورس الرسمية المشغولة من الجامعة اللبنانبة كلية العلوم الفرع الرابع شعبة بعلبك - غرفة رقم 5,ماروني,462,161,2,0,159
بعلبك,دورس حي السيدة ,مدرسة دورس الرسمية المشغولة من الجامعة اللبنانبة كلية العلوم الفرع الرابع شعبة بعلبك - غرفة رقم 6,ماروني,446,141,4,1,137
بعلبك,دورس حي السيدة ,مدرسة دورس الرسمية المشغولة من الجامعة اللبنانبة كلية العلوم الفرع الرابع شعبة بعلبك - غرفة رقم 7,مختلف,454,165,6,1,159
بعلبك,دورس حي الشحاديه ,مدرسة دورس الرسمية المشغولة من الجامعة اللبنانبة كلية العلوم الفرع الرابع شعبة بعلبك - غرفة رقم 4,شيعي,219,126,4,1,122
بعلبك,دول إقليمية,دول إقليمية,مختلف,2590,1584,21,7,1563
بعلبك,دير الاحمر ,ثانوية دير الاحمر الرسمية المبنى الجديد - غرفة رقم 1,ماروني,599,340,8,1,332
بعلبك,دير الاحمر ,ثانوية دير الاحمر الرسمية المبنى الجديد - غرفة رقم 2,ماروني,609,370,0,0,370
بعلبك,دير الاحمر ,ثانوية دير الاحمر الرسمية المبنى الجديد - غرفة رقم 3,ماروني,610,377,11,0,366
بعلبك,دير الاحمر ,ثانوية دير الاحمر الرسمية المبنى الجديد - غرفة رقم 4,ماروني,600,341,3,1,338
بعلبك,دير الاحمر ,ثانوية دير الاحمر الرسمية المبنى الجديد - غرفة رقم 5,ماروني,591,365,4,1,361
بعلبك,دير الاحمر ,ثانوية دير الاحمر الرسمية المبنى الجديد - غرفة رقم 6,مسيحي,575,343,6,0,337
بعلبك,دير الاحمر ,متوسطة دير الاحمر الرسمية - غرفة رقم 1,ماروني,605,349,8,2,341
بعلبك,دير الاحمر ,متوسطة دير الاحمر الرسمية - غرفة رقم 2,ماروني,558,382,4,2,378
بعلبك,دير الاحمر ,متوسطة دير الاحمر الرسمية - غرفة رقم 3,ماروني,577,382,2,3,380
بعلبك,دير الاحمر ,متوسطة دير الاحمر الرسمية - غرفة رقم 4,ماروني,595,386,6,1,380
بعلبك,دير الاحمر ,متوسطة دير الاحمر الرسمية - غرفة رقم 5,ماروني,581,357,4,2,353
بعلبك,دير الاحمر ,متوسطة دير الاحمر الرسمية - غرفة رقم 6,مسيحي,570,362,5,2,357
بعلبك,راس بعلبك ,التكميلية الرسمية - غرفة رقم 1,روم كاثوليك,563,281,3,0,278
بعلبك,راس بعلبك ,التكميلية الرسمية - غرفة رقم 2,روم كاثوليك,590,359,10,2,349
بعلبك,راس بعلبك ,التكميلية الرسمية - غرفة رقم 3,روم كاثوليك,595,333,6,2,327
بعلبك,راس بعلبك ,التكميلية الرسمية - غرفة رقم 4,مختلف,534,185,4,0,181
بعلبك,راس بعلبك ,الثانوية الرسمية - غرفة رقم 1,روم كاثوليك,529,236,2,0,234
بعلبك,راس بعلبك ,الثانوية الرسمية - غرفة رقم 2,روم كاثوليك,548,265,0,0,265
بعلبك,راس بعلبك ,الثانوية الرسمية - غرفة رقم 3,روم كاثوليك,536,268,4,1,264
بعلبك,راس بعلبك ,الثانوية الرسمية - غرفة رقم 4,روم كاثوليك,541,223,2,0,221
بعلبك,راس بعلبك ,الثانوية الرسمية - غرفة رقم 5,روم كاثوليك,545,230,2,1,228
بعلبك,رماسا ,الحسينية في البلدة - غرفة رقم 1,شيعي,402,242,6,0,236
بعلبك,ريحا ,حسينية البلدة - غرفة رقم 1,شيعي,543,321,0,1,321
بعلبك,ريحا ,حسينية البلدة - غرفة رقم 2,شيعي,575,337,1,0,336
بعلبك,ريحا ,حسينية البلدة - غرفة رقم 3,شيعي,547,324,2,0,322
بعلبك,زبود ,المدرسة الرسمية - غرفة رقم 1,شيعي,506,335,9,1,326
بعلبك,زبود ,المدرسة الرسمية - غرفة رقم 2,شيعي,517,401,2,2,399
بعلبك,سرعين التحتا ,بلدية سرعين التحتا - غرفة رقم 1,ماروني,478,161,1,0,160
بعلبك,سرعين التحتا ,بلدية سرعين التحتا - غرفة رقم 2,ماروني,551,208,0,3,208
بعلبك,سرعين التحتا ,بلدية سرعين التحتا - غرفة رقم 3,مختلف,147,147,0,1,147
بعلبك,سرعين الفوقا حي الجامع ,المدرسة الرسمية - غرفة رقم 4,شيعي,168,127,2,0,125
بعلبك,سرعين الفوقا حي الحارة ,المدرسة الرسمية - غرفة رقم 5,شيعي,113,70,3,0,67
بعلبك,سرعين الفوقا شرقي ,النادي الحسيني - غرفة رقم 1,شيعي,517,307,4,0,303
بعلبك,سرعين الفوقا شرقي ,النادي الحسيني - غرفة رقم 2,مختلف,514,364,2,1,362
بعلبك,سرعين الفوقا شرقي ,النادي الحسيني - غرفة رقم 3,مختلف,489,235,1,2,234
بعلبك,سرعين الفوقا غربي ,المدرسة الرسمية - غرفة رقم 1,شيعي,522,304,4,0,300
بعلبك,سرعين الفوقا غربي ,المدرسة الرسمية - غرفة رقم 2,شيعي,508,368,4,0,364
بعلبك,سرعين الفوقا غربي ,المدرسة الرسمية - غرفة رقم 3,مختلف,515,319,1,0,318
بعلبك,شعت حي الجامع ,المدرسة الرسمية - غرفة رقم 1,شيعي,606,367,2,1,365
بعلبك,شعت حي الجامع ,المدرسة الرسمية - غرفة رقم 2,شيعي,594,351,16,1,335
بعلبك,شعت حي الجامع ,المدرسة الرسمية - غرفة رقم 3,شيعي,602,344,10,0,334
بعلبك,شعت حي الجامع ,المدرسة الرسمية - غرفة رقم 4,شيعي,578,320,4,1,316
بعلبك,شعت حي الجامع ,المدرسة الرسمية - غرفة رقم 5,شيعي,614,387,7,4,380
بعلبك,شعت حي الجامع ,المدرسة الرسمية - غرفة رقم 6,شيعي,600,333,10,2,323
بعلبك,شعت حي الجامع ,المدرسة الرسمية - غرفة رقم 7,مسلم,573,319,4,1,315
بعلبك,شعت حي الضهر ,المدرسة الرسمية - غرفة رقم 10,سني,546,219,18,0,201
بعلبك,شعت حي الضهر ,المدرسة الرسمية - غرفة رقم 8,سني,573,286,5,7,281
بعلبك,شعت حي الضهر ,المدرسة الرسمية - غرفة رقم 9,سني,545,309,4,0,305
بعلبك,شليفا ,المدرسة الرسمية - غرفة رقم 1,ماروني,582,238,2,2,236
بعلبك,شليفا ,المدرسة الرسمية - غرفة رقم 2,مختلف,556,223,6,2,217
بعلبك,شليفا ,المدرسة الرسمية - غرفة رقم 3,ماروني,550,235,3,1,232
بعلبك,شليفا ,المدرسة الرسمية - غرفة رقم 4,مختلف,519,194,2,0,192
بعلبك,شمسطار الجنوبي ,ثانوية شمسطار الجنوبي - غرفة رقم 1,شيعي,614,292,2,0,290
بعلبك,شمسطار الجنوبي ,ثانوية شمسطار الجنوبي - غرفة رقم 2,شيعي,596,283,5,2,278
بعلبك,شمسطار الجنوبي ,ثانوية شمسطار الجنوبي - غرفة رقم 3,شيعي,634,336,12,1,324
بعلبك,شمسطار الجنوبي ,ثانوية شمسطار الجنوبي - غرفة رقم 4,شيعي,661,340,1,1,339
بعلبك,شمسطار الشرقي ,ثانوية شمسطار الجنوبي - غرفة رقم 5,شيعي,621,363,10,0,353
بعلبك,شمسطار الشرقي ,ثانوية شمسطار الجنوبي - غرفة رقم 6,شيعي,588,340,4,2,336
بعلبك,شمسطار الشرقي ,ثانوية شمسطار الجنوبي - غرفة رقم 7,شيعي,648,408,9,1,399
بعلبك,شمسطار الشرقي ,ثانوية شمسطار الجنوبي - غرفة رقم 8,شيعي,621,390,10,0,380
بعلبك,شمسطار الشمالي ,المدرسة المتوسطة الرسمية للصبيان - غرفة رقم 1,شيعي,605,305,12,1,293
بعلبك,شمسطار الشمالي ,المدرسة المتوسطة الرسمية للصبيان - غرفة رقم 2,شيعي,618,306,3,1,303
بعلبك,شمسطار الشمالي ,المدرسة المتوسطة الرسمية للصبيان - غرفة رقم 3,شيعي,596,362,5,0,357
بعلبك,شمسطار الشمالي ,المدرسة المتوسطة الرسمية للصبيان - غرفة رقم 4,شيعي,588,338,6,2,332
بعلبك,شمسطار الشمالي ,المدرسة المتوسطة الرسمية للصبيان - غرفة رقم 5,شيعي,608,386,2,0,384
بعلبك,شمسطار الشمالي ,المدرسة المتوسطة الرسمية للصبيان - غرفة رقم 6,شيعي,583,331,1,1,330
بعلبك,شمسطار الشمالي ,المدرسة المتوسطة الرسمية للصبيان - غرفة رقم 7,مسلم,563,314,5,1,309
بعلبك,شمسطار الغربي ,ثانوية شمسطار الجنوبي - غرفة رقم 10,شيعي,597,373,5,5,368
بعلبك,شمسطار الغربي ,ثانوية شمسطار الجنوبي - غرفة رقم 11,شيعي,582,323,6,1,317
بعلبك,شمسطار الغربي ,ثانوية شمسطار الجنوبي - غرفة رقم 12,شيعي,583,308,7,2,301
بعلبك,شمسطار الغربي ,ثانوية شمسطار الجنوبي - غرفة رقم 13,شيعي,652,367,3,0,364
بعلبك,شمسطار الغربي ,ثانوية شمسطار الجنوبي - غرفة رقم 14,شيعي,625,379,3,0,376
بعلبك,شمسطار الغربي ,ثانوية شمسطار الجنوبي - غرفة رقم 15,شيعي,612,355,0,0,355
بعلبك,شمسطار الغربي ,ثانوية شمسطار الجنوبي - غرفة رقم 16,شيعي,628,345,3,1,342
بعلبك,شمسطار الغربي ,ثانوية شمسطار الجنوبي - غرفة رقم 9,شيعي,581,323,0,0,323
بعلبك,صبوبا ,المدرسة الرسمية - غرفة رقم 1,شيعي,5830,362,0,0,362
بعلبك,صفرا ,صالة الكنيسة في الصفرا - غرفة رقم 1,ماروني,321,269,4,1,265
بعلبك,طاريا الجنوبي ,المدرسة المتوسطة الرسمية - غرفة رقم 1,شيعي,621,366,5,0,361
بعلبك,طاريا الجنوبي ,المدرسة المتوسطة الرسمية - غرفة رقم 2,شيعي,651,337,20,0,317
بعلبك,طاريا الجنوبي ,المدرسة المتوسطة الرسمية - غرفة رقم 3,شيعي,673,482,5,0,477
بعلبك,طاريا الجنوبي ,المدرسة المتوسطة الرسمية - غرفة رقم 4,شيعي,697,464,1,1,463
بعلبك,طاريا الشمالي ,ثانوية طاريا - غرفة رقم 1,شيعي,578,354,0,0,354
بعلبك,طاريا الشمالي ,ثانوية طاريا - غرفة رقم 2,شيعي,573,319,6,1,313
بعلبك,طاريا الشمالي ,ثانوية طاريا - غرفة رقم 3,شيعي,559,336,2,2,334
بعلبك,طاريا الشمالي ,ثانوية طاريا - غرفة رقم 4,شيعي,625,473,0,2,473
بعلبك,طاريا الشمالي ,ثانوية طاريا - غرفة رقم 5,شيعي,618,425,10,0,415
بعلبك,طاريا الشمالي ,ثانوية طاريا - غرفة رقم 6,شيعي,607,423,6,0,417
بعلبك,طفيل ,المدرسة الرسمية في معربون - غرفة رقم 4,مختلف,381,172,4,6,168
بعلبك,طفيل ,المدرسة الرسمية في معربون - غرفة رقم 5,مختلف,413,195,2,2,193
بعلبك,طليا ,دار البلدية - غرفة رقم 1,مختلف,486,180,0,0,180
بعلبك,طليا ,دار البلدية - غرفة رقم 2,مختلف,452,196,3,1,193
بعلبك,عرسال جنوبي ,مدرسة جواهر الاداب ( زهرة الاداب سابقا) - غرفة رقم 1,سني,680,354,9,1,345
بعلبك,عرسال جنوبي ,مدرسة جواهر الاداب ( زهرة الاداب سابقا) - غرفة رقم 10,سني,631,321,9,0,312
بعلبك,عرسال جنوبي ,مدرسة جواهر الاداب ( زهرة الاداب سابقا) - غرفة رقم 11,سني,603,347,5,1,342
بعلبك,عرسال جنوبي ,مدرسة جواهر الاداب ( زهرة الاداب سابقا) - غرفة رقم 2,سني,670,388,8,0,380
بعلبك,عرسال جنوبي ,مدرسة جواهر الاداب ( زهرة الاداب سابقا) - غرفة رقم 3,سني,665,360,5,1,355
بعلبك,عرسال جنوبي ,مدرسة جواهر الاداب ( زهرة الاداب سابقا) - غرفة رقم 4,سني,660,380,10,0,370
بعلبك,عرسال جنوبي ,مدرسة جواهر الاداب ( زهرة الاداب سابقا) - غرفة رقم 5,سني,654,373,22,1,351
بعلبك,عرسال جنوبي ,مدرسة جواهر الاداب ( زهرة الاداب سابقا) - غرفة رقم 6,سني,564,271,2,1,269
بعلبك,عرسال جنوبي ,مدرسة جواهر الاداب ( زهرة الاداب سابقا) - غرفة رقم 7,سني,692,339,5,0,334
بعلبك,عرسال جنوبي ,مدرسة جواهر الاداب ( زهرة الاداب سابقا) - غرفة رقم 8,سني,622,327,9,1,318
بعلبك,عرسال جنوبي ,مدرسة جواهر الاداب ( زهرة الاداب سابقا) - غرفة رقم 9,سني,630,301,27,3,274
بعلبك,عرسال شرقي ,مدرسة جواهر الاداب ( زهرة الاداب سابقا) - غرفة رقم 12,سني,56,49,2,0,47
بعلبك,عرسال شمالي ,مهنية عرسال الفنية - غرفة رقم 1,سني,611,335,0,0,335
بعلبك,عرسال شمالي ,مهنية عرسال الفنية - غرفة رقم 10,سني,640,359,13,1,346
بعلبك,عرسال شمالي ,مهنية عرسال الفنية - غرفة رقم 11,سني,647,345,4,2,341
بعلبك,عرسال شمالي ,مهنية عرسال الفنية - غرفة رقم 12,سني,602,312,8,0,304
بعلبك,عرسال شمالي ,مهنية عرسال الفنية - غرفة رقم 13,سني,659,421,2,1,419
بعلبك,عرسال شمالي ,مهنية عرسال الفنية - غرفة رقم 14,سني,673,381,4,1,377
بعلبك,عرسال شمالي ,مهنية عرسال الفنية - غرفة رقم 2,سني,636,380,5,2,375
بعلبك,عرسال شمالي ,مهنية عرسال الفنية - غرفة رقم 3,سني,655,408,20,3,388
بعلبك,عرسال شمالي ,مهنية عرسال الفنية - غرفة رقم 4,سني,655,378,13,1,365
بعلبك,عرسال شمالي ,مهنية عرسال الفنية - غرفة رقم 5,سني,632,350,9,0,341
بعلبك,عرسال شمالي ,مهنية عرسال الفنية - غرفة رقم 6,سني,625,408,0,0,408
بعلبك,عرسال شمالي ,مهنية عرسال الفنية - غرفة رقم 7,سني,619,373,11,2,362
بعلبك,عرسال شمالي ,مهنية عرسال الفنية - غرفة رقم 8,سني,630,331,5,3,326
بعلبك,عرسال شمالي ,مهنية عرسال الفنية - غرفة رقم 9,سني,638,373,14,0,359
بعلبك,عين السوداء ,المدرسة الرسمية - غرفة رقم 1,شيعي,266,195,2,0,193
بعلبك,عين بورضاي ,صالون كنيسة مار جرجس - غرفة رقم 1,مختلف,336,166,0,2,166
بعلبك,عين بورضاي ,صالون كنيسة مار جرجس - غرفة رقم 2,مختلف,360,169,6,0,163
بعلبك,عيناتا ,التكميلية الرسمية - غرفة رقم 1,ماروني,447,290,3,1,287
بعلبك,عيناتا ,التكميلية الرسمية - غرفة رقم 2,ماروني,463,305,4,0,301
بعلبك,عيناتا ,التكميلية الرسمية - غرفة رقم 3,ماروني,343,312,3,1,309
بعلبك,غفره ,مدرسة النور - غرفة رقم 1,سني,619,312,4,2,308
بعلبك,غفره ,مدرسة النور - غرفة رقم 2,سني,617,325,9,2,316
بعلبك,غفره ,مدرسة النور - غرفة رقم 3,سني,599,244,11,3,233
بعلبك,غفره ,مدرسة النور - غرفة رقم 4,سني,608,318,13,4,305
بعلبك,غفره ,مدرسة النور - غرفة رقم 5,سني,595,293,17,1,276
بعلبك,غفره ,مدرسة النور - غرفة رقم 6,سني,585,290,14,1,276
بعلبك,غفره ,مدرسة النور - غرفة رقم 7,سني,624,272,9,2,263
بعلبك,فلاوي ,متوسطة فلاوي الرسمية - غرفة رقم 1,شيعي,579,372,9,0,363
بعلبك,فلاوي ,متوسطة فلاوي الرسمية - غرفة رقم 2,شيعي,612,420,2,2,418
بعلبك,قبة دورس ,ثانوية خليل مطران (معهد العلوم التطبيقية سابقاً) - غرفة رقم 11,مسلم,158,107,2,0,105
بعلبك,قرحا ,المدرسة الرسمية في قرحا - غرفة رقم 1,شيعي,572,418,3,0,415
بعلبك,قصرنبا ,المدرسة الرسمية - غرفة رقم 1,شيعي,565,346,3,3,343
بعلبك,قصرنبا ,المدرسة الرسمية - غرفة رقم 2,شيعي,569,334,9,5,325
بعلبك,قصرنبا ,المدرسة الرسمية - غرفة رقم 3,مسلم,573,415,17,2,398
بعلبك,قصرنبا ,المدرسة الرسمية - غرفة رقم 4,شيعي,550,389,8,0,381
بعلبك,قصرنبا ,المدرسة الرسمية - غرفة رقم 5,مسلم,564,374,4,4,370
بعلبك,قلد السبع ,حسينية البلدة - غرفة رقم 1,شيعي,486,239,4,1,235
بعلبك,قلد السبع ,حسينية البلدة - غرفة رقم 2,شيعي,509,326,5,0,321
بعلبك,قلعة ,ثانوية خليل مطران (معهد العلوم التطبيقية سابقاً) - غرفة رقم 5,سني,638,340,9,1,331
بعلبك,قلعة ,ثانوية خليل مطران (معهد العلوم التطبيقية سابقاً) - غرفة رقم 6,سني,651,372,3,1,369
بعلبك,قلعة ,ثانوية خليل مطران (معهد العلوم التطبيقية سابقاً) - غرفة رقم 7,سني,651,324,13,2,311
بعلبك,قلعة ,ثانوية خليل مطران (معهد العلوم التطبيقية سابقاً) - غرفة رقم 8,سني,644,372,19,1,353
بعلبك,قلعة ,ثانوية خليل مطران (معهد العلوم التطبيقية سابقاً) - غرفة رقم 9,سني,622,296,1,1,295
بعلبك,قلعة غربي ,ثانوية خليل مطران (معهد العلوم التطبيقية سابقاً) - غرفة رقم 10,سني,72,48,1,0,47
بعلبك,كفردان ,مدرسة كفردان الرسمية - غرفة رقم 1,شيعي,507,325,1,0,324
بعلبك,كفردان ,مدرسة كفردان الرسمية - غرفة رقم 2,شيعي,513,340,0,0,340
بعلبك,كفردان الغربي ,مدرسة كفردان الرسمية - غرفة رقم 3,شيعي,539,352,2,3,350
بعلبك,كفردبش ,النادي الحسيني في البلدة - غرفة رقم 1,شيعي,600,347,0,2,347
بعلبك,مجدلون ,دار البلدية - غرفة رقم 1,مختلف,497,286,2,3,284
بعلبك,مجدلون ,دار البلدية - غرفة رقم 2,مختلف,551,303,0,0,303
بعلبك,مزرعة ابو صليبي ,المدرسة الرسمية - غرفة رقم 1,ماروني,450,256,1,1,255
بعلبك,مزرعة آل سويدان ,مبنى البلدية - غرفة رقم 1,شيعي,422,238,6,1,232
بعلبك,مزرعة التوت ,الحسينية - غرفة رقم 1,شيعي,516,228,1,0,227
بعلبك,مزرعة السيد ,صالون كنسية مار جرجس - غرفة رقم 1,ماروني,148,91,3,0,88
بعلبك,مزرعة الضليل ,المدرسة الرسمية - غرفة رقم 1,شيعي,252,164,3,0,161
بعلبك,مزرعة بيت مطر ,غرفة تابعة للوقف حنب كنيسة مار انطونيوس - غرفة رقم 1,ماروني,157,126,0,2,126
بعلبك,مصنع الزهرة ,المدرسة الرسمية - غرفة رقم 1,شيعي,520,314,7,0,307
بعلبك,معربون ,المدرسة الرسمية - غرفة رقم 1,سني,511,210,10,1,200
بعلبك,معربون ,المدرسة الرسمية - غرفة رقم 2,سني,522,290,6,2,284
بعلبك,معربون ,المدرسة الرسمية - غرفة رقم 3,سني,501,243,7,1,236
بعلبك,مقراق ,المدرسة الرسمية في مقراق - غرفة رقم 1,شيعي,340,254,8,2,246
بعلبك,مقراق ,المدرسة الرسمية في مقراق - غرفة رقم 2,شيعي,367,293,5,2,288
بعلبك,مقنه ,المدرسة الرسمية - غرفة رقم 1,مسلم,609,359,8,1,351
بعلبك,مقنه ,المدرسة الرسمية - غرفة رقم 2,مسلم,568,356,3,4,353
بعلبك,مقنه ,المدرسة الرسمية - غرفة رقم 3,شيعي,587,370,3,2,367
بعلبك,مقنه ,المدرسة الرسمية - غرفة رقم 4,شيعي,625,369,9,3,360
بعلبك,مقنه ,المدرسة الرسمية - غرفة رقم 5,شيعي,618,377,11,1,366
بعلبك,مقنه ,المدرسة الرسمية - غرفة رقم 6,شيعي,630,375,0,2,375
بعلبك,مقنه ,المدرسة الرسمية - غرفة رقم 7,شيعي,625,388,6,0,382
بعلبك,مقنه ,المدرسة الرسمية - غرفة رقم 8,شيعي,647,406,5,4,401
بعلبك,نبحا الحرفوش ,المدرسة الرسمية - غرفة رقم 1,شيعي,266,195,0,0,195
بعلبك,نبحا الدمدوم ,المدرسة الرسمية - غرفة رقم 1,شيعي,622,385,3,2,382
بعلبك,نبحا الدمدوم ,المدرسة الرسمية - غرفة رقم 2,شيعي,593,348,2,1,346
بعلبك,نبحا الدمدوم ,المدرسة الرسمية - غرفة رقم 3,شيعي,661,430,7,1,423
بعلبك,نبحا الدمدوم ,المدرسة الرسمية - غرفة رقم 4,شيعي,639,403,10,0,393
بعلبك,نبحا الدمدوم ,المدرسة الرسمية - غرفة رقم 5,شيعي,588,343,12,2,331
بعلبك,نبحا المحفارة ,دار بلدية نبحا المحفارة - غرفة رقم 1,ماروني,354,181,0,0,181
بعلبك,نبحا المحفارة ,دار بلدية نبحا المحفارة - غرفة رقم 2,ماروني,341,166,5,0,161
بعلبك,نبحا حي الجامع ,المدرسة الرسمية - غرفة رقم 6,شيعي,110,81,0,0,81
بعلبك,نبحا قليلة ,المدرسة الرسمية - غرفة رقم 1,شيعي,301,233,0,0,233
بعلبك,نحله ,المدرسة الرسمية - غرفة رقم 1,شيعي,624,410,8,3,402
بعلبك,نحله ,المدرسة الرسمية - غرفة رقم 2,شيعي,604,383,9,1,374
بعلبك,نحله ,المدرسة الرسمية - غرفة رقم 3,شيعي,636,328,0,0,328
بعلبك,نحله ,المدرسة الرسمية - غرفة رقم 4,شيعي,626,327,4,1,323
بعلبك,نحله ,المدرسة الرسمية - غرفة رقم 5,مسلم,606,316,11,0,305
بعلبك,نحله ,دار البلدية القديم - غرفة رقم 1,شيعي,625,301,2,1,299
بعلبك,نحله ,دار البلدية القديم - غرفة رقم 2,مسلم,629,381,4,0,377
بعلبك,وادي الزين ,المدرسة الرسمية - غرفة رقم 1,شيعي,526,413,0,0,413
بعلبك,وادي الصفا الشرقي ,المدرسة الرسمية - غرفة رقم 1,شيعي,402,303,2,0,301
بعلبك,وادي المشمشه ,حسينية وادي المشمشة - غرفة رقم 1,شيعي,222,178,12,1,166
بعلبك,وادي فعرة ,مركز بلدية وادي فعره - غرفة رقم 1,شيعي,488,329,1,0,328
بعلبك,وادي فعرة ,مركز بلدية وادي فعره - غرفة رقم 2,شيعي,492,335,5,2,330
بعلبك,يحفوفا ,المدرسة الرسمية - غرفة رقم 1,مسلم,370,209,1,1,208
بعلبك,يحفوفا ,المدرسة الرسمية - غرفة رقم 2,مسلم,364,252,2,1,250
بعلبك,يونين جنوبي ,المدرسة الرسمية في بلدة يونين - غرفة رقم 1,شيعي,638,353,0,2,353
بعلبك,يونين جنوبي ,المدرسة الرسمية في بلدة يونين - غرفة رقم 2,شيعي,658,396,7,2,389
بعلبك,يونين جنوبي ,المدرسة الرسمية في بلدة يونين - غرفة رقم 3,شيعي,618,347,10,0,337
بعلبك,يونين جنوبي ,المدرسة الرسمية في بلدة يونين - غرفة رقم 4,شيعي,658,360,15,1,345
بعلبك,يونين جنوبي ,المدرسة الرسمية في بلدة يونين - غرفة رقم 5,شيعي,664,384,9,0,375
بعلبك,يونين جنوبي ,المدرسة الرسمية في بلدة يونين - غرفة رقم 6,شيعي,664,409,5,0,404
بعلبك,يونين شرقي ,حسينية آل الاطرش - غرفة رقم 1,شيعي,463,347,1,0,346
بعلبك,يونين شمالي ,المدرسة الرسمية في بلدة يونين - غرفة رقم 10,شيعي,694,368,0,0,368
بعلبك,يونين شمالي ,المدرسة الرسمية في بلدة يونين - غرفة رقم 11,شيعي,645,410,0,0,410
بعلبك,يونين شمالي ,المدرسة الرسمية في بلدة يونين - غرفة رقم 12,مسلم,661,379,7,2,372
بعلبك,يونين شمالي ,المدرسة الرسمية في بلدة يونين - غرفة رقم 7,شيعي,725,369,19,0,350
بعلبك,يونين شمالي ,المدرسة الرسمية في بلدة يونين - غرفة رقم 8,شيعي,673,385,2,1,383
بعلبك,يونين شمالي ,المدرسة الرسمية في بلدة يونين - غرفة رقم 9,مسلم,632,371,10,0,361
بعلبك,يونين غربي ,المدرسة الخيرية لآل درة - غرفة رقم 1,شيعي,385,246,2,1,244
بعلبك,يونين غربي ,المدرسة الخيرية لآل درة - غرفة رقم 2,مسلم,396,297,1,0,296
بنت جبيل,السلطانيه ,المدرسة الرسمية (مبنى البلدية) - غرفة رقم 1,شيعي,640,242,4,2,238
بنت جبيل,السلطانيه ,المدرسة الرسمية (مبنى البلدية) - غرفة رقم 2,شيعي,634,277,3,2,274
بنت جبيل,السلطانيه ,المدرسة الرسمية (مبنى البلدية) - غرفة رقم 3,شيعي,613,260,2,3,258
بنت جبيل,الطيري ,المدرسة الرسميه - غرفة رقم 1,شيعي,574,333,1,2,332
بنت جبيل,الطيري ,المدرسة الرسميه - غرفة رقم 2,شيعي,537,323,1,0,322
بنت جبيل,الطيري ,المدرسة الرسميه - غرفة رقم 3,شيعي,564,355,3,0,352
بنت جبيل,الطيري ,المدرسة الرسميه - غرفة رقم 4,شيعي,535,338,4,3,334
بنت جبيل,الطيري ,المدرسة الرسميه - غرفة رقم 5,شيعي,563,267,2,1,265
بنت جبيل,برج قلاويه ,المدرسة الرسمية المبنى الجديد - غرفة رقم 1,شيعي,457,285,1,4,284
بنت جبيل,برج قلاويه ,المدرسة الرسمية المبنى الجديد - غرفة رقم 2,شيعي,425,333,4,2,329
بنت جبيل,برعشيت ,المدرسة الرسمية الجديدة - غرفة رقم 1,شيعي,608,250,5,2,245
بنت جبيل,برعشيت ,المدرسة الرسمية الجديدة - غرفة رقم 10,مختلف,577,181,1,1,180
بنت جبيل,برعشيت ,المدرسة الرسمية الجديدة - غرفة رقم 2,شيعي,631,299,3,3,296
بنت جبيل,برعشيت ,المدرسة الرسمية الجديدة - غرفة رقم 3,شيعي,586,286,0,1,286
بنت جبيل,برعشيت ,المدرسة الرسمية الجديدة - غرفة رقم 4,شيعي,612,277,2,6,275
بنت جبيل,برعشيت ,المدرسة الرسمية الجديدة - غرفة رقم 5,مختلف,549,136,2,0,134
بنت جبيل,برعشيت ,المدرسة الرسمية الجديدة - غرفة رقم 6,شيعي,632,263,3,1,260
بنت جبيل,برعشيت ,المدرسة الرسمية الجديدة - غرفة رقم 7,شيعي,607,292,2,2,290
بنت جبيل,برعشيت ,المدرسة الرسمية الجديدة - غرفة رقم 8,شيعي,601,297,1,0,296
بنت جبيل,برعشيت ,المدرسة الرسمية الجديدة - غرفة رقم 9,شيعي,608,271,1,1,270
بنت جبيل,بنت جبيل حي البركه ,مدرسة بنت جبيل الثانية المختلطة الرسمية - غرفة رقم 1,شيعي,607,136,1,3,135
بنت جبيل,بنت جبيل حي البركه ,مدرسة بنت جبيل الثانية المختلطة الرسمية - غرفة رقم 2,شيعي,581,170,1,2,169
بنت جبيل,بنت جبيل حي البركه ,مدرسة بنت جبيل الثانية المختلطة الرسمية - غرفة رقم 3,شيعي,607,211,4,6,207
بنت جبيل,بنت جبيل حي البركه ,مدرسة بنت جبيل الثانية المختلطة الرسمية - غرفة رقم 4,شيعي,606,227,1,3,226
بنت جبيل,بنت جبيل حي البركه ,مدرسة بنت جبيل الثانية المختلطة الرسمية - غرفة رقم 5,شيعي,620,164,2,1,162
بنت جبيل,بنت جبيل حي البركه ,مدرسة بنت جبيل الثانية المختلطة الرسمية - غرفة رقم 6,شيعي,589,172,1,1,171
بنت جبيل,بنت جبيل حي البركه ,مدرسة بنت جبيل الثانية المختلطة الرسمية - غرفة رقم 7,شيعي,592,189,0,1,189
بنت جبيل,بنت جبيل حي البركه ,مدرسة بنت جبيل الثانية المختلطة الرسمية - غرفة رقم 8,شيعي,589,235,7,2,228
بنت جبيل,بنت جبيل حي البركه ,مدرسة بنت جبيل الثانية المختلطة الرسمية - غرفة رقم 9,شيعي,622,211,4,2,207
بنت جبيل,بنت جبيل حي الجامع ,مدرسة فريال شامي الرسمية حي آل جمعه - غرفة رقم 1,شيعي,613,144,1,4,143
بنت جبيل,بنت جبيل حي الجامع ,مدرسة فريال شامي الرسمية حي آل جمعه - غرفة رقم 2,شيعي,613,213,6,4,207
بنت جبيل,بنت جبيل حي الجامع ,مدرسة فريال شامي الرسمية حي آل جمعه - غرفة رقم 3,شيعي,662,165,3,8,162
بنت جبيل,بنت جبيل حي الجامع ,مدرسة فريال شامي الرسمية حي آل جمعه - غرفة رقم 4,شيعي,612,199,4,4,195
بنت جبيل,بنت جبيل حي الحسينية ,ثانوية بنت جبيل الرسمية - غرفة رقم 1,شيعي,625,167,2,1,165
بنت جبيل,بنت جبيل حي الحسينية ,ثانوية بنت جبيل الرسمية - غرفة رقم 2,شيعي,602,157,1,1,156
بنت جبيل,بنت جبيل حي الحسينية ,ثانوية بنت جبيل الرسمية - غرفة رقم 3,شيعي,582,142,0,0,142
بنت جبيل,بنت جبيل حي الحسينية ,ثانوية بنت جبيل الرسمية - غرفة رقم 4,شيعي,589,151,0,1,151
بنت جبيل,بنت جبيل حي الحسينية ,ثانوية بنت جبيل الرسمية - غرفة رقم 5,شيعي,599,207,2,1,205
بنت جبيل,بنت جبيل حي الحسينية ,ثانوية بنت جبيل الرسمية - غرفة رقم 6,شيعي,612,127,1,0,126
بنت جبيل,بنت جبيل حي الحسينية ,ثانوية بنت جبيل الرسمية - غرفة رقم 7,شيعي,589,171,0,2,171
بنت جبيل,بنت جبيل حي الحواره ,مدرسة بنت جبيل الرسمية - غرفة رقم 10,شيعي,574,190,4,4,186
بنت جبيل,بنت جبيل حي الحواره ,مدرسة بنت جبيل الرسمية - غرفة رقم 11,شيعي,585,216,2,1,214
بنت جبيل,بنت جبيل حي الحواره ,مدرسة بنت جبيل الرسمية - غرفة رقم 12,شيعي,599,271,2,3,269
بنت جبيل,بنت جبيل حي الحواره ,مدرسة بنت جبيل الرسمية - غرفة رقم 13,شيعي,595,193,1,3,192
بنت جبيل,بنت جبيل حي الحواره ,مدرسة بنت جبيل الرسمية - غرفة رقم 8,شيعي,558,180,3,1,177
بنت جبيل,بنت جبيل حي الحواره ,مدرسة بنت جبيل الرسمية - غرفة رقم 9,شيعي,564,237,2,1,235
بنت جبيل,بنت جبيل حي عين الصغيرة ,فرع الجامعة اللبنانية في بنت جبيل - غرفة رقم 1,شيعي,589,134,1,3,133
بنت جبيل,بنت جبيل حي عين الصغيرة ,فرع الجامعة اللبنانية في بنت جبيل - غرفة رقم 10,شيعي,573,166,4,3,162
بنت جبيل,بنت جبيل حي عين الصغيرة ,فرع الجامعة اللبنانية في بنت جبيل - غرفة رقم 11,شيعي,607,157,1,1,156
بنت جبيل,بنت جبيل حي عين الصغيرة ,فرع الجامعة اللبنانية في بنت جبيل - غرفة رقم 12,شيعي,580,134,1,0,133
بنت جبيل,بنت جبيل حي عين الصغيرة ,فرع الجامعة اللبنانية في بنت جبيل - غرفة رقم 2,شيعي,595,168,5,4,163
بنت جبيل,بنت جبيل حي عين الصغيرة ,فرع الجامعة اللبنانية في بنت جبيل - غرفة رقم 3,شيعي,585,113,1,1,112
بنت جبيل,بنت جبيل حي عين الصغيرة ,فرع الجامعة اللبنانية في بنت جبيل - غرفة رقم 4,شيعي,594,163,0,2,163
بنت جبيل,بنت جبيل حي عين الصغيرة ,فرع الجامعة اللبنانية في بنت جبيل - غرفة رقم 5,شيعي,582,156,5,3,151
بنت جبيل,بنت جبيل حي عين الصغيرة ,فرع الجامعة اللبنانية في بنت جبيل - غرفة رقم 6,شيعي,576,132,6,5,126
بنت جبيل,بنت جبيل حي عين الصغيرة ,فرع الجامعة اللبنانية في بنت جبيل - غرفة رقم 7,شيعي,596,141,0,0,141
بنت جبيل,بنت جبيل حي عين الصغيرة ,فرع الجامعة اللبنانية في بنت جبيل - غرفة رقم 8,شيعي,601,180,3,3,177
بنت جبيل,بنت جبيل حي عين الصغيرة ,فرع الجامعة اللبنانية في بنت جبيل - غرفة رقم 9,شيعي,595,130,1,0,129
بنت جبيل,بنت جبيل موظفون ,سراي بنت جبيل - غرفة رقم 1,مختلف,424,362,1,5,361
بنت جبيل,بنت جبيل موظفون ,سراي بنت جبيل - غرفة رقم 2,مختلف,362,292,1,6,291
بنت جبيل,بيت ليف ,المدرسة الابتدائية الرسمية (مدرسة الشهيد موسى بداح الرسمية) - غرفة رقم 1,شيعي,579,343,13,3,330
بنت جبيل,بيت ليف ,المدرسة الابتدائية الرسمية (مدرسة الشهيد موسى بداح الرسمية) - غرفة رقم 2,شيعي,635,426,2,2,424
بنت جبيل,بيت ليف ,المدرسة الابتدائية الرسمية (مدرسة الشهيد موسى بداح الرسمية) - غرفة رقم 3,شيعي,650,319,3,1,316
بنت جبيل,بيت ليف ,المدرسة الابتدائية الرسمية (مدرسة الشهيد موسى بداح الرسمية) - غرفة رقم 4,شيعي,657,412,1,4,411
بنت جبيل,بيت ليف ,المدرسة الابتدائية الرسمية (مدرسة الشهيد موسى بداح الرسمية) - غرفة رقم 5,شيعي,687,499,5,2,494
بنت جبيل,بيت ليف ,المدرسة الابتدائية الرسمية (مدرسة الشهيد موسى بداح الرسمية) - غرفة رقم 6,شيعي,692,402,1,2,401
بنت جبيل,بيت ياحون ,النادي الحسيني - غرفة رقم 1,شيعي,466,185,2,0,183
بنت جبيل,بيت ياحون ,النادي الحسيني - غرفة رقم 2,شيعي,479,176,1,5,175
بنت جبيل,بيت ياحون ,النادي الحسيني - غرفة رقم 3,شيعي,482,206,0,2,206
بنت جبيل,بيت ياحون ,النادي الحسيني - غرفة رقم 4,شيعي,490,198,1,3,197
بنت جبيل,تبنين حي آل بري ,مجمع الرئيس نبيه بري التربوي الطابق الأول - غرفة رقم 1,شيعي,417,148,3,1,145
بنت جبيل,تبنين حي التحتاني ,مجمع الرئيس نبيه بري التربوي - غرفة رقم 2,شيعي,588,239,4,1,235
بنت جبيل,تبنين حي التحتاني ,مجمع الرئيس نبيه بري التربوي - غرفة رقم 3,شيعي,570,227,6,7,221
بنت جبيل,تبنين حي التحتاني ,مجمع الرئيس نبيه بري التربوي - غرفة رقم 4,شيعي,579,264,2,2,262
بنت جبيل,تبنين حي التحتاني ,مجمع الرئيس نبيه بري التربوي - غرفة رقم 5,شيعي,565,243,2,3,241
بنت جبيل,تبنين حي التحتاني ,مجمع الرئيس نبيه بري التربوي - غرفة رقم 6,شيعي,592,249,3,3,246
بنت جبيل,تبنين حي الفوقاني ,مجمع الرئيس نبيه بري التربوي - غرفة رقم 10,شيعي,529,138,1,3,137
بنت جبيل,تبنين حي الفوقاني ,مجمع الرئيس نبيه بري التربوي - غرفة رقم 11,شيعي,537,102,1,3,101
بنت جبيل,تبنين حي الفوقاني ,مجمع الرئيس نبيه بري التربوي - غرفة رقم 7,مختلف,567,143,1,5,142
بنت جبيل,تبنين حي الفوقاني ,مجمع الرئيس نبيه بري التربوي - غرفة رقم 8,شيعي,141,141,3,2,138
بنت جبيل,تبنين حي الفوقاني ,مجمع الرئيس نبيه بري التربوي - غرفة رقم 9,شيعي,568,147,2,3,145
بنت جبيل,تبنين حي الكاثوليك ,مجمع الرئيس نبيه بري التربوي - غرفة رقم 12,روم كاثوليك,545,127,3,4,124
بنت جبيل,جميجمه ,المدرسة الرسمية(مركز البلدية) - غرفة رقم 1,شيعي,687,430,7,4,423
بنت جبيل,جميجمه ,المدرسة الرسمية(مركز البلدية) - غرفة رقم 2,شيعي,665,465,2,7,463
بنت جبيل,حاريص ,المدرسة الرسمية - غرفة رقم 1,شيعي,607,213,3,1,210
بنت جبيل,حاريص ,المدرسة الرسمية - غرفة رقم 2,شيعي,607,214,4,3,210
بنت جبيل,حاريص ,المدرسة الرسمية - غرفة رقم 3,شيعي,607,187,2,2,185
بنت جبيل,حاريص ,المدرسة الرسمية - غرفة رقم 4,شيعي,614,222,1,2,221
بنت جبيل,حاريص ,المدرسة الرسمية - غرفة رقم 5,شيعي,595,300,6,1,294
بنت جبيل,حاريص ,المدرسة الرسمية - غرفة رقم 6,شيعي,586,277,3,1,274
بنت جبيل,حاريص ,المدرسة الرسمية - غرفة رقم 7,شيعي,611,254,7,3,247
بنت جبيل,حاريص ,المدرسة الرسمية - غرفة رقم 8,شيعي,583,280,3,0,277
بنت جبيل,حاريص ,المدرسة الرسمية - غرفة رقم 9,شيعي,590,218,1,1,217
بنت جبيل,حانين ,المقر البلدي - غرفة رقم 1,شيعي,424,247,2,0,245
بنت جبيل,حانين ,المقر البلدي - غرفة رقم 2,شيعي,396,208,1,1,207
بنت جبيل,حانين ,المقر البلدي - غرفة رقم 3,شيعي,453,266,5,1,261
بنت جبيل,حانين ,المقر البلدي - غرفة رقم 4,شيعي,440,254,0,2,254
بنت جبيل,حداثا ,المدرسة الرسمية - غرفة رقم 1,شيعي,550,212,1,2,211
بنت جبيل,حداثا ,المدرسة الرسمية - غرفة رقم 2,شيعي,584,289,0,3,289
بنت جبيل,حداثا ,المدرسة الرسمية - غرفة رقم 3,شيعي,566,269,3,7,266
بنت جبيل,حداثا ,المدرسة الرسمية - غرفة رقم 4,شيعي,532,186,1,2,185
بنت جبيل,حداثا ,المدرسة الرسمية - غرفة رقم 5,شيعي,564,290,0,2,290
بنت جبيل,حداثا ,المدرسة الرسمية - غرفة رقم 6,شيعي,545,271,0,6,271
بنت جبيل,حداثا ,المدرسة الرسمية - غرفة رقم 7,شيعي,558,215,3,2,212
بنت جبيل,خربة سلم ,المدرسة الرسمية - غرفة رقم 1,شيعي,629,351,0,3,351
بنت جبيل,خربة سلم ,المدرسة الرسمية - غرفة رقم 2,شيعي,630,338,0,1,338
بنت جبيل,خربة سلم ,المدرسة الرسمية - غرفة رقم 3,شيعي,615,321,3,1,318
بنت جبيل,خربة سلم ,المدرسة الرسمية - غرفة رقم 4,شيعي,631,319,6,4,313
بنت جبيل,خربة سلم ,المدرسة الرسمية - غرفة رقم 5,شيعي,605,334,1,0,333
بنت جبيل,خربة سلم ,المدرسة الرسمية - غرفة رقم 6,شيعي,637,330,2,0,328
بنت جبيل,خربة سلم ,المدرسة الرسمية - غرفة رقم 7,شيعي,642,320,1,2,319
بنت جبيل,خربة سلم ,المدرسة الرسمية - غرفة رقم 8,شيعي,618,342,3,4,339
بنت جبيل,دبل ,المتوسطة الرسمية - غرفة رقم 1,ماروني,463,133,1,0,132
بنت جبيل,دبل ,المتوسطة الرسمية - غرفة رقم 2,ماروني,426,150,2,0,148
بنت جبيل,دبل ,المتوسطة الرسمية - غرفة رقم 3,ماروني,453,108,4,1,104
بنت جبيل,دبل ,المتوسطة الرسمية - غرفة رقم 4,ماروني,524,196,2,2,194
بنت جبيل,دبل ,المتوسطة الرسمية - غرفة رقم 5,ماروني,500,190,3,2,187
بنت جبيل,دبل ,المتوسطة الرسمية - غرفة رقم 6,ماروني,461,123,4,1,119
بنت جبيل,دول إقليمية,دول إقليمية,مختلف,2799,1445,27,13,1418
بنت جبيل,دير انطار ,المدرسة الرسمية - غرفة رقم 1,شيعي,529,259,1,8,258
بنت جبيل,دير انطار ,المدرسة الرسمية - غرفة رقم 2,شيعي,571,224,2,0,222
بنت جبيل,دير انطار ,المدرسة الرسمية - غرفة رقم 3,شيعي,519,182,7,5,175
بنت جبيل,دير انطار ,المدرسة الرسمية - غرفة رقم 4,شيعي,523,278,7,0,271
بنت جبيل,دير انطار ,المدرسة الرسمية - غرفة رقم 5,شيعي,542,247,2,1,245
بنت جبيل,دير انطار ,المدرسة الرسمية - غرفة رقم 6,شيعي,532,224,1,2,223
بنت جبيل,راميه ,المدرسة الرسمية - غرفة رقم 1,شيعي,490,265,4,6,261
بنت جبيل,راميه ,المدرسة الرسمية - غرفة رقم 2,شيعي,522,300,4,4,296
بنت جبيل,راميه ,المدرسة الرسمية - غرفة رقم 3,شيعي,497,298,4,3,294
بنت جبيل,راميه ,المدرسة الرسمية - غرفة رقم 4,شيعي,511,333,4,5,329
بنت جبيل,رشاف ,المدرسة الرسمية - غرفة رقم 1,شيعي,613,342,1,3,341
بنت جبيل,رشاف ,المدرسة الرسمية - غرفة رقم 2,شيعي,603,286,1,4,285
بنت جبيل,رشاف ,المدرسة الرسمية - غرفة رقم 3,شيعي,587,346,1,3,345
بنت جبيل,رشاف ,المدرسة الرسمية - غرفة رقم 4,شيعي,577,318,0,3,318
بنت جبيل,رميش ,مدرسة رميش المتوسطة الرسمية - غرفة رقم 1,ماروني,554,188,1,1,187
بنت جبيل,رميش ,مدرسة رميش المتوسطة الرسمية - غرفة رقم 10,ماروني,546,197,9,3,188
بنت جبيل,رميش ,مدرسة رميش المتوسطة الرسمية - غرفة رقم 2,ماروني,577,229,5,3,224
بنت جبيل,رميش ,مدرسة رميش المتوسطة الرسمية - غرفة رقم 3,ماروني,578,214,7,2,207
بنت جبيل,رميش ,مدرسة رميش المتوسطة الرسمية - غرفة رقم 4,ماروني,580,239,1,0,238
بنت جبيل,رميش ,مدرسة رميش المتوسطة الرسمية - غرفة رقم 5,ماروني,561,172,4,1,168
بنت جبيل,رميش ,مدرسة رميش المتوسطة الرسمية - غرفة رقم 6,ماروني,565,230,2,2,228
بنت جبيل,رميش ,مدرسة رميش المتوسطة الرسمية - غرفة رقم 7,ماروني,582,285,0,3,285
بنت جبيل,رميش ,مدرسة رميش المتوسطة الرسمية - غرفة رقم 8,ماروني,552,280,7,2,273
بنت جبيل,رميش ,مدرسة رميش المتوسطة الرسمية - غرفة رقم 9,ماروني,580,269,7,3,262
بنت جبيل,شقرا ,ثانوية السيد محسن الامين الرسمية - غرفة رقم 1,شيعي,615,283,1,1,282
بنت جبيل,شقرا ,ثانوية السيد محسن الامين الرسمية - غرفة رقم 10,شيعي,640,287,4,1,283
بنت جبيل,شقرا ,ثانوية السيد محسن الامين الرسمية - غرفة رقم 11,شيعي,568,272,3,0,269
بنت جبيل,شقرا ,ثانوية السيد محسن الامين الرسمية - غرفة رقم 12,شيعي,624,322,4,6,318
بنت جبيل,شقرا ,ثانوية السيد محسن الامين الرسمية - غرفة رقم 2,شيعي,615,254,0,1,254
بنت جبيل,شقرا ,ثانوية السيد محسن الامين الرسمية - غرفة رقم 3,شيعي,610,266,0,3,266
بنت جبيل,شقرا ,ثانوية السيد محسن الامين الرسمية - غرفة رقم 4,شيعي,600,244,2,3,242
بنت جبيل,شقرا ,ثانوية السيد محسن الامين الرسمية - غرفة رقم 5,شيعي,640,281,4,2,277
بنت جبيل,شقرا ,ثانوية السيد محسن الامين الرسمية - غرفة رقم 6,شيعي,564,248,3,1,245
بنت جبيل,شقرا ,ثانوية السيد محسن الامين الرسمية - غرفة رقم 7,شيعي,595,283,1,3,282
بنت جبيل,شقرا ,ثانوية السيد محسن الامين الرسمية - غرفة رقم 8,شيعي,599,265,4,1,261
بنت جبيل,شقرا ,ثانوية السيد محسن الامين الرسمية - غرفة رقم 9,شيعي,590,299,1,0,298
بنت جبيل,صربين ,المدرسة الرسمية - غرفة رقم 1,شيعي,542,306,3,6,303
بنت جبيل,صربين ,المدرسة الرسمية - غرفة رقم 2,شيعي,507,274,1,2,273
بنت جبيل,صفد البطيخ ,المدرسة الرسمية - غرفة رقم 1,مختلف,565,276,2,6,274
بنت جبيل,صفد البطيخ ,المدرسة الرسمية - غرفة رقم 2,مختلف,607,305,0,6,305
بنت جبيل,عيتا الجبل ,المدرسة الرسمية المبنى الجديد - غرفة رقم 1,شيعي,428,173,0,0,173
بنت جبيل,عيتا الجبل ,المدرسة الرسمية المبنى الجديد - غرفة رقم 2,شيعي,447,186,2,2,184
بنت جبيل,عيتا الجبل ,المدرسة الرسمية المبنى الجديد - غرفة رقم 3,شيعي,415,178,3,0,175
بنت جبيل,عيتا الجبل ,المدرسة الرسمية المبنى الجديد - غرفة رقم 4,شيعي,434,184,3,1,181
بنت جبيل,عيتا الجبل ,المدرسة الرسمية المبنى الجديد - غرفة رقم 5,شيعي,433,193,2,2,191
بنت جبيل,عيتا الجبل ,المدرسة الرسمية المبنى الجديد - غرفة رقم 6,شيعي,447,211,2,2,209
بنت جبيل,عيتا الشعب ,الثانوية الرسمية - غرفة رقم 1,شيعي,675,434,3,2,431
بنت جبيل,عيتا الشعب ,الثانوية الرسمية - غرفة رقم 2,شيعي,653,383,5,5,378
بنت جبيل,عيتا الشعب ,الثانوية الرسمية - غرفة رقم 3,شيعي,658,402,1,2,401
بنت جبيل,عيتا الشعب ,الثانوية الرسمية - غرفة رقم 4,شيعي,662,418,2,7,416
بنت جبيل,عيتا الشعب ,المدرسة الرسمية - غرفة رقم 1,شيعي,664,496,0,0,496
بنت جبيل,عيتا الشعب ,المدرسة الرسمية - غرفة رقم 2,شيعي,684,447,5,3,442
بنت جبيل,عيتا الشعب ,المدرسة الرسمية - غرفة رقم 3,شيعي,673,455,4,2,451
بنت جبيل,عيتا الشعب ,المدرسة الرسمية - غرفة رقم 4,شيعي,657,458,1,1,457
بنت جبيل,عيترون ,مدرسة الشهيد سعيد مواسي المتوسطة - غرفة رقم 1,شيعي,679,234,4,0,230
بنت جبيل,عيترون ,مدرسة الشهيد سعيد مواسي المتوسطة - غرفة رقم 2,شيعي,669,257,7,3,250
بنت جبيل,عيترون ,مدرسة الشهيد سعيد مواسي المتوسطة - غرفة رقم 3,شيعي,660,280,0,4,280
بنت جبيل,عيترون ,مدرسة الشهيد سعيد مواسي المتوسطة - غرفة رقم 4,شيعي,648,267,1,4,266
بنت جبيل,عيترون ,مدرسة الشهيد سعيد مواسي المتوسطة - غرفة رقم 5,شيعي,657,292,3,1,289
بنت جبيل,عيترون ,مدرسة الشهيد سعيد مواسي المتوسطة - غرفة رقم 6,شيعي,610,256,6,3,250
بنت جبيل,عيترون ,مدرسة الشهيد سعيد مواسي المتوسطة - غرفة رقم 7,شيعي,637,251,7,1,244
بنت جبيل,عيترون ,مدرسة الشهيد سعيد مواسي المتوسطة - غرفة رقم 8,شيعي,637,263,2,5,261
بنت جبيل,عيترون ,مدرسة عيترون الرسمية المختلطة - غرفة رقم 1,شيعي,655,201,3,3,198
بنت جبيل,عيترون ,مدرسة عيترون الرسمية المختلطة - غرفة رقم 2,شيعي,646,214,4,2,210
بنت جبيل,عيترون ,مدرسة عيترون الرسمية المختلطة - غرفة رقم 3,شيعي,667,257,4,4,253
بنت جبيل,عيترون ,مدرسة عيترون الرسمية المختلطة - غرفة رقم 4,شيعي,665,276,4,1,272
بنت جبيل,عيترون ,مدرسة عيترون الرسمية المختلطة - غرفة رقم 5,شيعي,634,275,8,3,267
بنت جبيل,عيترون ,مدرسة عيترون الرسمية المختلطة - غرفة رقم 6,شيعي,636,255,4,0,251
بنت جبيل,عيترون ,مدرسة عيترون الرسمية المختلطة - غرفة رقم 7,شيعي,642,215,4,2,211
بنت جبيل,عيترون ,مدرسة عيترون الرسمية المختلطة - غرفة رقم 8,شيعي,631,224,2,1,222
بنت جبيل,عين ابل حي الدير ,مدرسة راهبات عين ابل - غرفة رقم 10,مسيحي,602,154,2,2,152
بنت جبيل,عين ابل حي الدير ,مدرسة راهبات عين ابل - غرفة رقم 9,مسيحي,563,149,0,1,149
بنت جبيل,عين ابل حي العين ,مدرسة راهبات عين ابل - غرفة رقم 1,ماروني,438,145,4,4,141
بنت جبيل,عين ابل حي العين ,مدرسة راهبات عين ابل - غرفة رقم 2,ماروني,428,69,0,1,69
بنت جبيل,عين ابل حي العين ,مدرسة راهبات عين ابل - غرفة رقم 3,ماروني,467,153,0,3,153
بنت جبيل,عين ابل حي العين ,مدرسة راهبات عين ابل - غرفة رقم 4,ماروني,443,62,1,1,61
بنت جبيل,عين ابل حي العين ,مدرسة راهبات عين ابل - غرفة رقم 5,مختلف,594,136,3,0,133
بنت جبيل,عين ابل حي الكنيسة ,مدرسة راهبات عين ابل - غرفة رقم 6,ماروني,403,124,2,1,122
بنت جبيل,عين ابل حي الكنيسة ,مدرسة راهبات عين ابل - غرفة رقم 7,ماروني,411,117,0,2,117
بنت جبيل,عين ابل حي الكنيسة ,مدرسة راهبات عين ابل - غرفة رقم 8,ماروني,414,76,1,0,75
بنت جبيل,عيناتا ,مدرسة عيناتا المتوسطة الرسمية - غرفة رقم 1,شيعي,572,247,4,1,243
بنت جبيل,عيناتا ,مدرسة عيناتا المتوسطة الرسمية - غرفة رقم 10,شيعي,645,272,0,3,272
بنت جبيل,عيناتا ,مدرسة عيناتا المتوسطة الرسمية - غرفة رقم 2,شيعي,607,226,1,0,225
بنت جبيل,عيناتا ,مدرسة عيناتا المتوسطة الرسمية - غرفة رقم 3,شيعي,621,223,2,5,221
بنت جبيل,عيناتا ,مدرسة عيناتا المتوسطة الرسمية - غرفة رقم 4,شيعي,606,219,2,0,217
بنت جبيل,عيناتا ,مدرسة عيناتا المتوسطة الرسمية - غرفة رقم 5,شيعي,605,224,0,0,224
بنت جبيل,عيناتا ,مدرسة عيناتا المتوسطة الرسمية - غرفة رقم 6,شيعي,668,332,4,1,328
بنت جبيل,عيناتا ,مدرسة عيناتا المتوسطة الرسمية - غرفة رقم 7,شيعي,630,296,0,4,296
بنت جبيل,عيناتا ,مدرسة عيناتا المتوسطة الرسمية - غرفة رقم 8,شيعي,602,259,0,3,259
بنت جبيل,عيناتا ,مدرسة عيناتا المتوسطة الرسمية - غرفة رقم 9,شيعي,643,280,6,2,274
بنت جبيل,غندورية ,المدرسة الرسمية - غرفة رقم 1,شيعي,629,398,0,0,398
بنت جبيل,فرون ,المدرسة الرسمية - غرفة رقم 1,شيعي,496,301,6,8,295
بنت جبيل,فرون ,المدرسة الرسمية - غرفة رقم 2,شيعي,486,352,3,7,349
بنت جبيل,قلاويه ,المدرسة الرسمية - غرفة رقم 1,شيعي,464,321,3,11,318
بنت جبيل,قلاويه ,المدرسة الرسمية - غرفة رقم 2,شيعي,485,371,2,7,369
بنت جبيل,قلاويه ,المدرسة الرسمية - غرفة رقم 3,شيعي,460,290,3,5,287
بنت جبيل,قوزح ,مبنى بلدية القوزح - غرفة رقم 1,ماروني,378,142,2,2,140
بنت جبيل,قوزح ,مبنى بلدية القوزح - غرفة رقم 2,ماروني,435,128,0,2,128
بنت جبيل,كفردونين ,المدرسة الرسمية - غرفة رقم 1,شيعي,542,229,0,1,229
بنت جبيل,كفردونين ,المدرسة الرسمية - غرفة رقم 2,شيعي,549,254,0,5,254
بنت جبيل,كفردونين ,المدرسة الرسمية - غرفة رقم 3,شيعي,548,203,1,2,202
بنت جبيل,كفردونين ,المدرسة الرسمية - غرفة رقم 4,شيعي,529,223,2,1,221
بنت جبيل,كفردونين ,المدرسة الرسمية - غرفة رقم 5,شيعي,540,264,1,4,263
بنت جبيل,كفردونين ,المدرسة الرسمية - غرفة رقم 6,شيعي,561,221,1,0,220
بنت جبيل,كفره ,ثانوية كفرا الرسمية - غرفة رقم 1,شيعي,565,266,1,2,265
بنت جبيل,كفره ,ثانوية كفرا الرسمية - غرفة رقم 2,شيعي,576,268,5,0,263
بنت جبيل,كفره ,ثانوية كفرا الرسمية - غرفة رقم 3,شيعي,592,287,1,2,286
بنت جبيل,كفره ,ثانوية كفرا الرسمية - غرفة رقم 4,شيعي,559,267,0,1,267
بنت جبيل,كفره ,ثانوية كفرا الرسمية - غرفة رقم 5,شيعي,566,295,0,1,295
بنت جبيل,كفره ,ثانوية كفرا الرسمية - غرفة رقم 6,شيعي,571,317,1,2,316
بنت جبيل,كفره ,ثانوية كفرا الرسمية - غرفة رقم 7,شيعي,5816,291,1,3,290
بنت جبيل,كفره ,ثانوية كفرا الرسمية - غرفة رقم 8,شيعي,576,302,1,0,301
بنت جبيل,كونين ,المدرسة الرسمية - غرفة رقم 1,شيعي,579,248,0,0,248
بنت جبيل,كونين ,المدرسة الرسمية - غرفة رقم 2,شيعي,595,264,0,0,264
بنت جبيل,كونين ,المدرسة الرسمية - غرفة رقم 3,شيعي,608,260,1,1,259
بنت جبيل,كونين ,المدرسة الرسمية - غرفة رقم 4,شيعي,587,258,0,2,258
بنت جبيل,كونين ,المدرسة الرسمية - غرفة رقم 5,شيعي,592,271,6,0,265
بنت جبيل,كونين ,المدرسة الرسمية - غرفة رقم 6,شيعي,573,260,2,1,258
بنت جبيل,كونين ,المدرسة الرسمية - غرفة رقم 7,شيعي,539,274,5,2,269
بنت جبيل,كونين ,المدرسة الرسمية - غرفة رقم 8,شيعي,570,271,2,2,269
بنت جبيل,مارون الراس ,المدرسة الرسمية المبنى الجديد - غرفة رقم 1,شيعي,629,219,0,0,219
بنت جبيل,مارون الراس ,المدرسة الرسمية المبنى الجديد - غرفة رقم 2,شيعي,606,223,1,0,222
بنت جبيل,مارون الراس ,المدرسة الرسمية المبنى الجديد - غرفة رقم 3,شيعي,613,228,0,1,228
بنت جبيل,مارون الراس ,المدرسة الرسمية المبنى الجديد - غرفة رقم 4,شيعي,586,199,5,2,194
بنت جبيل,مارون الراس ,المدرسة الرسمية المبنى الجديد - غرفة رقم 5,شيعي,634,249,7,0,242
بنت جبيل,مارون الراس ,المدرسة الرسمية المبنى الجديد - غرفة رقم 6,شيعي,610,229,2,1,227
بنت جبيل,مارون الراس ,المدرسة الرسمية المبنى الجديد - غرفة رقم 7,شيعي,596,246,4,2,242
بنت جبيل,مارون الراس ,المدرسة الرسمية المبنى الجديد - غرفة رقم 8,شيعي,584,227,1,2,226
بنت جبيل,يارون ,النادي الحسيني - غرفة رقم 1,شيعي,631,105,0,1,105
بنت جبيل,يارون ,النادي الحسيني - غرفة رقم 2,شيعي,656,113,1,0,112
بنت جبيل,يارون ,النادي الحسيني - غرفة رقم 3,شيعي,601,89,0,0,89
بنت جبيل,يارون ,النادي الحسيني - غرفة رقم 4,شيعي,610,148,2,0,146
بنت جبيل,يارون ,النادي الحسيني - غرفة رقم 5,شيعي,604,152,2,0,150
بنت جبيل,يارون ,النادي الحسيني - غرفة رقم 6,شيعي,579,118,1,0,117
بنت جبيل,يارون ,مبنى البلدية - غرفة رقم 1,روم كاثوليك,538,81,3,5,78
بنت جبيل,يارون ,مبنى البلدية - غرفة رقم 2,روم كاثوليك,541,81,3,5,78
بنت جبيل,ياطر ,المدرسة الرسمية المبنى القديم - غرفة رقم 1,شيعي,624,333,4,1,329
بنت جبيل,ياطر ,المدرسة الرسمية المبنى القديم - غرفة رقم 2,شيعي,641,345,4,0,341
بنت جبيل,ياطر ,المدرسة الرسمية المبنى القديم - غرفة رقم 3,شيعي,622,346,2,2,344
بنت جبيل,ياطر ,المدرسة الرسمية المبنى القديم - غرفة رقم 4,شيعي,629,402,2,2,400
بنت جبيل,ياطر ,المدرسة الرسمية المبنى القديم - غرفة رقم 5,شيعي,645,364,0,0,364
بنت جبيل,ياطر ,المدرسة الرسمية المبنى القديم - غرفة رقم 6,شيعي,624,381,3,2,378
بنت جبيل,ياطر ,المدرسة الرسمية المبنى القديم - غرفة رقم 7,شيعي,616,290,4,2,286
بيروت الأولى,الأشرفية,المدرسة الثانوية لراهبات المحبة العازرية  - غرفة رقم 1,لاتين,534,85,0,0,85
بيروت الأولى,الأشرفية,المدرسة الثانوية لراهبات المحبة العازرية  - غرفة رقم 2,مختلف,592,121,1,3,120
بيروت الأولى,الأشرفية,المدرسة الثانوية لراهبات المحبة العازرية  - غرفة رقم 3,لاتين,547,105,2,0,103
بيروت الأولى,الأشرفية,المدرسة الثانوية لراهبات المحبة العازرية  - غرفة رقم 4,مختلف,574,110,1,0,109
بيروت الأولى,الأشرفية,ثانوية الاشرفية الاولى للبنين - غرفة رقم 1,روم ارثوذكس,580,171,0,0,171
بيروت الأولى,الأشرفية,ثانوية الاشرفية الاولى للبنين - غرفة رقم 10,سريان كاثوليك,565,138,6,0,132
بيروت الأولى,الأشرفية,ثانوية الاشرفية الاولى للبنين - غرفة رقم 11,سريان كاثوليك,569,170,6,2,164
بيروت الأولى,الأشرفية,ثانوية الاشرفية الاولى للبنين - غرفة رقم 12,سريان كاثوليك,552,193,1,0,192
بيروت الأولى,الأشرفية,ثانوية الاشرفية الاولى للبنين - غرفة رقم 13,سريان كاثوليك,560,228,2,1,226
بيروت الأولى,الأشرفية,ثانوية الاشرفية الاولى للبنين - غرفة رقم 2,روم ارثوذكس,577,181,1,1,180
بيروت الأولى,الأشرفية,ثانوية الاشرفية الاولى للبنين - غرفة رقم 3,روم ارثوذكس,232,176,2,1,174
بيروت الأولى,الأشرفية,ثانوية الاشرفية الاولى للبنين - غرفة رقم 4,روم ارثوذكس,579,224,3,2,221
بيروت الأولى,الأشرفية,ثانوية الاشرفية الاولى للبنين - غرفة رقم 5,روم ارثوذكس,596,303,8,2,295
بيروت الأولى,الأشرفية,ثانوية الاشرفية الاولى للبنين - غرفة رقم 6,مختلف,606,281,0,0,281
بيروت الأولى,الأشرفية,ثانوية الاشرفية الاولى للبنين - غرفة رقم 7,سريان كاثوليك,573,149,6,1,143
بيروت الأولى,الأشرفية,ثانوية الاشرفية الاولى للبنين - غرفة رقم 8,سريان كاثوليك,568,167,3,1,164
بيروت الأولى,الأشرفية,ثانوية الاشرفية الاولى للبنين - غرفة رقم 9,سريان كاثوليك,569,166,1,0,165
بيروت الأولى,الأشرفية,ثانوية علي بن ابي طالب - غرفة رقم 1,سني,609,272,7,4,265
بيروت الأولى,الأشرفية,ثانوية علي بن ابي طالب - غرفة رقم 10,سني,571,126,7,6,119
بيروت الأولى,الأشرفية,ثانوية علي بن ابي طالب - غرفة رقم 11,سني,593,212,9,2,203
بيروت الأولى,الأشرفية,ثانوية علي بن ابي طالب - غرفة رقم 12,مختلف,547,172,5,0,167
بيروت الأولى,الأشرفية,ثانوية علي بن ابي طالب - غرفة رقم 13,مختلف,580,175,2,0,173
بيروت الأولى,الأشرفية,ثانوية علي بن ابي طالب - غرفة رقم 2,سني,621,287,14,10,273
بيروت الأولى,الأشرفية,ثانوية علي بن ابي طالب - غرفة رقم 3,سني,623,276,7,4,269
بيروت الأولى,الأشرفية,ثانوية علي بن ابي طالب - غرفة رقم 4,سني,612,196,12,3,184
بيروت الأولى,الأشرفية,ثانوية علي بن ابي طالب - غرفة رقم 5,سني,610,223,4,2,219
بيروت الأولى,الأشرفية,ثانوية علي بن ابي طالب - غرفة رقم 6,سني,582,238,6,6,232
بيروت الأولى,الأشرفية,ثانوية علي بن ابي طالب - غرفة رقم 7,سني,561,216,8,5,208
بيروت الأولى,الأشرفية,ثانوية علي بن ابي طالب - غرفة رقم 8,سني,571,252,6,6,246
بيروت الأولى,الأشرفية,ثانوية علي بن ابي طالب - غرفة رقم 9,سني,571,199,11,5,188
بيروت الأولى,الأشرفية,ثانوية لور مغيزل للبنات الشحروري - غرفة رقم 1,أرمن ارثوذكس,551,133,4,1,129
بيروت الأولى,الأشرفية,ثانوية لور مغيزل للبنات الشحروري - غرفة رقم 10,أرمن ارثوذكس,542,114,1,1,113
بيروت الأولى,الأشرفية,ثانوية لور مغيزل للبنات الشحروري - غرفة رقم 11,أرمن ارثوذكس,546,223,3,3,220
بيروت الأولى,الأشرفية,ثانوية لور مغيزل للبنات الشحروري - غرفة رقم 12,أرمن ارثوذكس,550,293,14,2,279
بيروت الأولى,الأشرفية,ثانوية لور مغيزل للبنات الشحروري - غرفة رقم 13,مختلف,549,222,6,1,216
بيروت الأولى,الأشرفية,ثانوية لور مغيزل للبنات الشحروري - غرفة رقم 14,شيعي,587,195,12,1,183
بيروت الأولى,الأشرفية,ثانوية لور مغيزل للبنات الشحروري - غرفة رقم 15,شيعي,597,184,8,1,176
بيروت الأولى,الأشرفية,ثانوية لور مغيزل للبنات الشحروري - غرفة رقم 16,شيعي,614,207,5,4,202
بيروت الأولى,الأشرفية,ثانوية لور مغيزل للبنات الشحروري - غرفة رقم 2,أرمن ارثوذكس,553,97,0,1,97
بيروت الأولى,الأشرفية,ثانوية لور مغيزل للبنات الشحروري - غرفة رقم 3,أرمن ارثوذكس,540,95,0,3,95
بيروت الأولى,الأشرفية,ثانوية لور مغيزل للبنات الشحروري - غرفة رقم 4,أرمن ارثوذكس,559,140,5,0,135
بيروت الأولى,الأشرفية,ثانوية لور مغيزل للبنات الشحروري - غرفة رقم 5,أرمن ارثوذكس,575,317,19,4,298
بيروت الأولى,الأشرفية,ثانوية لور مغيزل للبنات الشحروري - غرفة رقم 6,أرمن ارثوذكس,569,284,10,1,274
بيروت الأولى,الأشرفية,ثانوية لور مغيزل للبنات الشحروري - غرفة رقم 7,أرمن ارثوذكس,537,136,3,2,133
بيروت الأولى,الأشرفية,ثانوية لور مغيزل للبنات الشحروري - غرفة رقم 8,أرمن ارثوذكس,540,115,0,0,115
بيروت الأولى,الأشرفية,ثانوية لور مغيزل للبنات الشحروري - غرفة رقم 9,أرمن ارثوذكس,516,68,5,0,63
بيروت الأولى,الأشرفية,مدرسة الاورغوي الرسمية المختلطة - غرفة رقم 1,ماروني,570,264,1,2,263
بيروت الأولى,الأشرفية,مدرسة الاورغوي الرسمية المختلطة - غرفة رقم 10,ماروني,598,274,2,1,272
بيروت الأولى,الأشرفية,مدرسة الاورغوي الرسمية المختلطة - غرفة رقم 11,مختلف,582,218,7,2,211
بيروت الأولى,الأشرفية,مدرسة الاورغوي الرسمية المختلطة - غرفة رقم 2,ماروني,552,204,14,0,190
بيروت الأولى,الأشرفية,مدرسة الاورغوي الرسمية المختلطة - غرفة رقم 3,ماروني,563,193,1,1,192
بيروت الأولى,الأشرفية,مدرسة الاورغوي الرسمية المختلطة - غرفة رقم 4,ماروني,575,203,0,0,203
بيروت الأولى,الأشرفية,مدرسة الاورغوي الرسمية المختلطة - غرفة رقم 5,ماروني,576,289,5,4,284
بيروت الأولى,الأشرفية,مدرسة الاورغوي الرسمية المختلطة - غرفة رقم 6,ماروني,578,257,5,0,252
بيروت الأولى,الأشرفية,مدرسة الاورغوي الرسمية المختلطة - غرفة رقم 7,ماروني,556,204,1,0,203
بيروت الأولى,الأشرفية,مدرسة الاورغوي الرسمية المختلطة - غرفة رقم 8,ماروني,557,198,1,0,197
بيروت الأولى,الأشرفية,مدرسة الاورغوي الرسمية المختلطة - غرفة رقم 9,ماروني,585,184,1,0,183
بيروت الأولى,الأشرفية,مدرسة التباريس الرسمية النموذجية – خلف كنيسة السيدة - غرفة رقم 1,روم ارثوذكس,561,307,0,0,307
بيروت الأولى,الأشرفية,مدرسة التباريس الرسمية النموذجية – خلف كنيسة السيدة - غرفة رقم 2,روم ارثوذكس,582,261,0,1,261
بيروت الأولى,الأشرفية,مدرسة التباريس الرسمية النموذجية – خلف كنيسة السيدة - غرفة رقم 3,روم ارثوذكس,582,291,6,1,285
بيروت الأولى,الأشرفية,مدرسة التباريس الرسمية النموذجية – خلف كنيسة السيدة - غرفة رقم 4,روم ارثوذكس,585,268,1,2,267
بيروت الأولى,الأشرفية,مدرسة التباريس الرسمية النموذجية – خلف كنيسة السيدة - غرفة رقم 5,روم ارثوذكس,566,222,2,0,220
بيروت الأولى,الأشرفية,مدرسة التباريس الرسمية النموذجية – خلف كنيسة السيدة - غرفة رقم 6,روم ارثوذكس,595,250,2,2,248
بيروت الأولى,الأشرفية,مدرسة التباريس الرسمية النموذجية – خلف كنيسة السيدة - غرفة رقم 7,روم ارثوذكس,604,252,0,1,252
بيروت الأولى,الأشرفية,مدرسة التباريس الرسمية النموذجية – خلف كنيسة السيدة - غرفة رقم 8,روم ارثوذكس,601,233,1,1,232
بيروت الأولى,الأشرفية,مدرسة روبنيان الارمنية - اول شارع البدوي  - غرفة رقم 1,أرمن كاثوليك,493,133,0,0,133
بيروت الأولى,الأشرفية,مدرسة روبنيان الارمنية - اول شارع البدوي  - غرفة رقم 2,أرمن كاثوليك,530,118,4,1,114
بيروت الأولى,الأشرفية,مدرسة روبنيان الارمنية - اول شارع البدوي  - غرفة رقم 3,أرمن كاثوليك,517,140,3,1,137
بيروت الأولى,الأشرفية,مدرسة روبنيان الارمنية - اول شارع البدوي  - غرفة رقم 4,أرمن كاثوليك,516,109,0,0,109
بيروت الأولى,الأشرفية,مدرسة روبنيان الارمنية - اول شارع البدوي  - غرفة رقم 5,أرمن كاثوليك,537,247,14,1,233
بيروت الأولى,الأشرفية,مدرسة زهرة الاحسان  - غرفة رقم 1,روم ارثوذكس,284,284,7,2,277
بيروت الأولى,الأشرفية,مدرسة زهرة الاحسان  - غرفة رقم 10,روم ارثوذكس,569,183,2,1,181
بيروت الأولى,الأشرفية,مدرسة زهرة الاحسان  - غرفة رقم 11,روم ارثوذكس,558,203,5,1,198
بيروت الأولى,الأشرفية,مدرسة زهرة الاحسان  - غرفة رقم 12,روم ارثوذكس,557,171,0,3,171
بيروت الأولى,الأشرفية,مدرسة زهرة الاحسان  - غرفة رقم 13,روم ارثوذكس,563,197,7,0,190
بيروت الأولى,الأشرفية,مدرسة زهرة الاحسان  - غرفة رقم 14,روم ارثوذكس,559,230,5,1,225
بيروت الأولى,الأشرفية,مدرسة زهرة الاحسان  - غرفة رقم 15,روم ارثوذكس,561,307,8,3,299
بيروت الأولى,الأشرفية,مدرسة زهرة الاحسان  - غرفة رقم 16,مختلف,564,250,2,0,248
بيروت الأولى,الأشرفية,مدرسة زهرة الاحسان  - غرفة رقم 2,روم ارثوذكس,556,256,6,1,250
بيروت الأولى,الأشرفية,مدرسة زهرة الاحسان  - غرفة رقم 3,روم ارثوذكس,531,254,7,0,247
بيروت الأولى,الأشرفية,مدرسة زهرة الاحسان  - غرفة رقم 4,روم ارثوذكس,560,263,3,0,260
بيروت الأولى,الأشرفية,مدرسة زهرة الاحسان  - غرفة رقم 5,روم ارثوذكس,545,207,4,2,203
بيروت الأولى,الأشرفية,مدرسة زهرة الاحسان  - غرفة رقم 6,روم ارثوذكس,565,229,4,0,225
بيروت الأولى,الأشرفية,مدرسة زهرة الاحسان  - غرفة رقم 7,روم ارثوذكس,565,249,1,0,248
بيروت الأولى,الأشرفية,مدرسة زهرة الاحسان  - غرفة رقم 8,روم ارثوذكس,566,194,7,3,187
بيروت الأولى,الأشرفية,مدرسة زهرة الاحسان  - غرفة رقم 9,روم ارثوذكس,559,202,4,1,198
بيروت الأولى,الأشرفية,مدرسة سلمى الصائغ الرسمية - غرفة رقم 1,روم كاثوليك,572,212,2,0,210
بيروت الأولى,الأشرفية,مدرسة سلمى الصائغ الرسمية - غرفة رقم 10,روم كاثوليك,574,175,0,0,175
بيروت الأولى,الأشرفية,مدرسة سلمى الصائغ الرسمية - غرفة رقم 11,روم كاثوليك,596,326,5,2,321
بيروت الأولى,الأشرفية,مدرسة سلمى الصائغ الرسمية - غرفة رقم 2,روم كاثوليك,570,127,0,1,127
بيروت الأولى,الأشرفية,مدرسة سلمى الصائغ الرسمية - غرفة رقم 3,روم كاثوليك,571,119,0,2,119
بيروت الأولى,الأشرفية,مدرسة سلمى الصائغ الرسمية - غرفة رقم 4,روم كاثوليك,576,130,0,2,130
بيروت الأولى,الأشرفية,مدرسة سلمى الصائغ الرسمية - غرفة رقم 5,روم كاثوليك,594,318,5,4,313
بيروت الأولى,الأشرفية,مدرسة سلمى الصائغ الرسمية - غرفة رقم 6,روم كاثوليك,561,206,5,0,201
بيروت الأولى,الأشرفية,مدرسة سلمى الصائغ الرسمية - غرفة رقم 7,روم كاثوليك,555,140,5,0,135
بيروت الأولى,الأشرفية,مدرسة سلمى الصائغ الرسمية - غرفة رقم 8,روم كاثوليك,552,100,3,1,97
بيروت الأولى,الأشرفية,مدرسة سلمى الصائغ الرسمية - غرفة رقم 9,روم كاثوليك,574,151,8,0,143
بيروت الأولى,الرميل,دار المعلمين و المعلمات المتوسطة - شارع يونس الجبيلي - غرفة رقم 1,روم كاثوليك,547,197,1,0,196
بيروت الأولى,الرميل,دار المعلمين و المعلمات المتوسطة - شارع يونس الجبيلي - غرفة رقم 2,روم كاثوليك,535,168,0,0,168
بيروت الأولى,الرميل,دار المعلمين و المعلمات المتوسطة - شارع يونس الجبيلي - غرفة رقم 3,روم كاثوليك,540,201,3,0,198
بيروت الأولى,الرميل,دار المعلمين و المعلمات المتوسطة - شارع يونس الجبيلي - غرفة رقم 4,روم كاثوليك,523,162,6,0,156
بيروت الأولى,الرميل,دار المعلمين و المعلمات المتوسطة - شارع يونس الجبيلي - غرفة رقم 5,روم كاثوليك,534,190,4,0,186
بيروت الأولى,الرميل,دار المعلمين و المعلمات المتوسطة - شارع يونس الجبيلي - غرفة رقم 6,روم كاثوليك,545,255,1,0,254
بيروت الأولى,الرميل,دار المعلمين و المعلمات المتوسطة - شارع يونس الجبيلي - غرفة رقم 7,سريان كاثوليك,572,188,3,1,185
بيروت الأولى,الرميل,دار المعلمين و المعلمات المتوسطة - شارع يونس الجبيلي - غرفة رقم 8,أرمن ارثوذكس,537,114,1,0,113
بيروت الأولى,الرميل,مدرسة الاشرفية الثالثة المتوسطة الرسمية المختلطة - شارع يونس الجبيلي - غرفة رقم 1,أرمن كاثوليك,481,130,0,1,130
بيروت الأولى,الرميل,مدرسة الاشرفية الثالثة المتوسطة الرسمية المختلطة - شارع يونس الجبيلي - غرفة رقم 2,أرمن كاثوليك,494,135,8,1,127
بيروت الأولى,الرميل,مدرسة الاشرفية الثالثة المتوسطة الرسمية المختلطة - شارع يونس الجبيلي - غرفة رقم 3,أرمن كاثوليك,491,99,3,0,96
بيروت الأولى,الرميل,مدرسة الاشرفية الثالثة المتوسطة الرسمية المختلطة - شارع يونس الجبيلي - غرفة رقم 4,إنجيلي,464,55,2,0,53
بيروت الأولى,الرميل,مدرسة الاشرفية الثالثة المتوسطة الرسمية المختلطة - شارع يونس الجبيلي - غرفة رقم 5,إنجيلي,472,41,1,0,40
بيروت الأولى,الرميل,مدرسة الاشرفية الثالثة المتوسطة الرسمية المختلطة - شارع يونس الجبيلي - غرفة رقم 6,مسيحي,509,129,1,4,128
بيروت الأولى,الرميل,مدرسة الاشرفية الثالثة المتوسطة الرسمية المختلطة - شارع يونس الجبيلي - غرفة رقم 7,مختلف,490,179,1,0,178
بيروت الأولى,الرميل,مدرسة الثلاثة اقمار - غرفة رقم 1,ماروني,566,261,7,2,254
بيروت الأولى,الرميل,مدرسة الثلاثة اقمار - غرفة رقم 10,ماروني,550,147,5,0,142
بيروت الأولى,الرميل,مدرسة الثلاثة اقمار - غرفة رقم 11,ماروني,566,137,1,0,136
بيروت الأولى,الرميل,مدرسة الثلاثة اقمار - غرفة رقم 12,ماروني,602,266,3,1,263
بيروت الأولى,الرميل,مدرسة الثلاثة اقمار - غرفة رقم 13,لاتين,561,94,0,1,94
بيروت الأولى,الرميل,مدرسة الثلاثة اقمار - غرفة رقم 14,لاتين,575,109,1,0,108
بيروت الأولى,الرميل,مدرسة الثلاثة اقمار - غرفة رقم 15,لاتين,566,42,0,0,42
بيروت الأولى,الرميل,مدرسة الثلاثة اقمار - غرفة رقم 2,ماروني,563,269,1,0,268
بيروت الأولى,الرميل,مدرسة الثلاثة اقمار - غرفة رقم 3,ماروني,570,280,0,1,280
بيروت الأولى,الرميل,مدرسة الثلاثة اقمار - غرفة رقم 4,ماروني,552,173,1,0,172
بيروت الأولى,الرميل,مدرسة الثلاثة اقمار - غرفة رقم 5,ماروني,550,150,2,0,148
بيروت الأولى,الرميل,مدرسة الثلاثة اقمار - غرفة رقم 6,ماروني,564,243,26,0,217
بيروت الأولى,الرميل,مدرسة الثلاثة اقمار - غرفة رقم 7,ماروني,555,274,2,1,272
بيروت الأولى,الرميل,مدرسة الثلاثة اقمار - غرفة رقم 8,ماروني,540,246,13,0,233
بيروت الأولى,الرميل,مدرسة الثلاثة اقمار - غرفة رقم 9,ماروني,557,225,3,0,222
بيروت الأولى,الرميل,مدرسة كيورك شاتلباشيان الارمنية - غرفة رقم 1,أرمن ارثوذكس,538,91,0,2,91
بيروت الأولى,الرميل,مدرسة كيورك شاتلباشيان الارمنية - غرفة رقم 10,أرمن ارثوذكس,546,110,5,0,105
بيروت الأولى,الرميل,مدرسة كيورك شاتلباشيان الارمنية - غرفة رقم 11,أرمن ارثوذكس,560,125,3,3,122
بيروت الأولى,الرميل,مدرسة كيورك شاتلباشيان الارمنية - غرفة رقم 12,أرمن ارثوذكس,560,143,3,1,140
بيروت الأولى,الرميل,مدرسة كيورك شاتلباشيان الارمنية - غرفة رقم 2,أرمن ارثوذكس,539,112,4,1,108
بيروت الأولى,الرميل,مدرسة كيورك شاتلباشيان الارمنية - غرفة رقم 3,أرمن ارثوذكس,527,90,2,0,88
بيروت الأولى,الرميل,مدرسة كيورك شاتلباشيان الارمنية - غرفة رقم 4,أرمن ارثوذكس,534,110,3,1,107
بيروت الأولى,الرميل,مدرسة كيورك شاتلباشيان الارمنية - غرفة رقم 5,أرمن ارثوذكس,553,121,13,1,108
بيروت الأولى,الرميل,مدرسة كيورك شاتلباشيان الارمنية - غرفة رقم 6,أرمن ارثوذكس,534,150,0,1,150
بيروت الأولى,الرميل,مدرسة كيورك شاتلباشيان الارمنية - غرفة رقم 7,أرمن ارثوذكس,542,94,2,1,92
بيروت الأولى,الرميل,مدرسة كيورك شاتلباشيان الارمنية - غرفة رقم 8,أرمن ارثوذكس,531,99,0,0,99
بيروت الأولى,الرميل,مدرسة كيورك شاتلباشيان الارمنية - غرفة رقم 9,أرمن ارثوذكس,515,82,3,0,79
بيروت الأولى,الرميل,مدرسة متوسطة الاشرفية الرسمية - شارع سامي البازجي - غرفة رقم 1,روم ارثوذكس,551,279,1,0,278
بيروت الأولى,الرميل,مدرسة متوسطة الاشرفية الرسمية - شارع سامي البازجي - غرفة رقم 10,روم ارثوذكس,560,131,1,0,130
بيروت الأولى,الرميل,مدرسة متوسطة الاشرفية الرسمية - شارع سامي البازجي - غرفة رقم 11,روم ارثوذكس,572,262,11,0,251
بيروت الأولى,الرميل,مدرسة متوسطة الاشرفية الرسمية - شارع سامي البازجي - غرفة رقم 2,روم ارثوذكس,558,268,0,0,268
بيروت الأولى,الرميل,مدرسة متوسطة الاشرفية الرسمية - شارع سامي البازجي - غرفة رقم 3,روم ارثوذكس,579,253,1,3,252
بيروت الأولى,الرميل,مدرسة متوسطة الاشرفية الرسمية - شارع سامي البازجي - غرفة رقم 4,روم ارثوذكس,555,178,1,0,177
بيروت الأولى,الرميل,مدرسة متوسطة الاشرفية الرسمية - شارع سامي البازجي - غرفة رقم 5,روم ارثوذكس,567,168,0,0,168
بيروت الأولى,الرميل,مدرسة متوسطة الاشرفية الرسمية - شارع سامي البازجي - غرفة رقم 6,روم ارثوذكس,563,255,7,1,248
بيروت الأولى,الرميل,مدرسة متوسطة الاشرفية الرسمية - شارع سامي البازجي - غرفة رقم 7,روم ارثوذكس,563,251,1,0,250
بيروت الأولى,الرميل,مدرسة متوسطة الاشرفية الرسمية - شارع سامي البازجي - غرفة رقم 8,روم ارثوذكس,552,222,4,0,218
بيروت الأولى,الرميل,مدرسة متوسطة الاشرفية الرسمية - شارع سامي البازجي - غرفة رقم 9,روم ارثوذكس,554,213,7,0,206
بيروت الأولى,الصيفي,مدرسة الفرير- القلب الاقدس بلوك A  - غرفة رقم 1,ماروني,528,211,0,0,211
بيروت الأولى,الصيفي,مدرسة الفرير- القلب الاقدس بلوك A  - غرفة رقم 10,روم كاثوليك,509,93,3,0,90
بيروت الأولى,الصيفي,مدرسة الفرير- القلب الاقدس بلوك A  - غرفة رقم 11,مختلف,519,87,1,0,86
بيروت الأولى,الصيفي,مدرسة الفرير- القلب الاقدس بلوك A  - غرفة رقم 2,ماروني,514,184,2,4,182
بيروت الأولى,الصيفي,مدرسة الفرير- القلب الاقدس بلوك A  - غرفة رقم 3,مختلف,540,117,0,0,117
بيروت الأولى,الصيفي,مدرسة الفرير- القلب الاقدس بلوك A  - غرفة رقم 4,ماروني,506,200,3,1,197
بيروت الأولى,الصيفي,مدرسة الفرير- القلب الاقدس بلوك A  - غرفة رقم 5,ماروني,509,182,9,1,173
بيروت الأولى,الصيفي,مدرسة الفرير- القلب الاقدس بلوك A  - غرفة رقم 6,ماروني,492,97,1,0,96
بيروت الأولى,الصيفي,مدرسة الفرير- القلب الاقدس بلوك A  - غرفة رقم 7,روم كاثوليك,515,178,0,1,178
بيروت الأولى,الصيفي,مدرسة الفرير- القلب الاقدس بلوك A  - غرفة رقم 8,روم كاثوليك,511,88,0,0,88
بيروت الأولى,الصيفي,مدرسة الفرير- القلب الاقدس بلوك A  - غرفة رقم 9,روم كاثوليك,549,218,16,1,202
بيروت الأولى,الصيفي,مدرسة الفرير- القلب الاقدس بلوك B  - غرفة رقم 1,روم ارثوذكس,519,187,1,1,186
بيروت الأولى,الصيفي,مدرسة الفرير- القلب الاقدس بلوك B  - غرفة رقم 2,مختلف,522,138,1,0,137
بيروت الأولى,الصيفي,مدرسة الفرير- القلب الاقدس بلوك B  - غرفة رقم 3,روم ارثوذكس,522,209,7,0,202
بيروت الأولى,الصيفي,مدرسة الفرير- القلب الاقدس بلوك B  - غرفة رقم 4,مختلف,514,111,0,0,111
بيروت الأولى,الصيفي,مدرسة الفرير- القلب الاقدس بلوك B  - غرفة رقم 5,مختلف,491,122,3,1,119
بيروت الأولى,الصيفي,مدرسة الفرير- القلب الاقدس بلوك B  - غرفة رقم 6,مختلف,481,140,1,0,139
بيروت الأولى,الصيفي,مدرسة الفرير- القلب الاقدس بلوك B  - غرفة رقم 7,مختلف,511,147,2,2,145
بيروت الأولى,المدور,المدرسة المركزية الارمنية الانجيلية - غرفة رقم 1,أرمن ارثوذكس,510,117,7,2,110
بيروت الأولى,المدور,المدرسة المركزية الارمنية الانجيلية - غرفة رقم 10,أرمن ارثوذكس,501,101,1,0,100
بيروت الأولى,المدور,المدرسة المركزية الارمنية الانجيلية - غرفة رقم 11,أرمن ارثوذكس,510,107,3,1,104
بيروت الأولى,المدور,المدرسة المركزية الارمنية الانجيلية - غرفة رقم 2,أرمن ارثوذكس,503,96,2,2,94
بيروت الأولى,المدور,المدرسة المركزية الارمنية الانجيلية - غرفة رقم 3,أرمن ارثوذكس,517,111,0,1,111
بيروت الأولى,المدور,المدرسة المركزية الارمنية الانجيلية - غرفة رقم 4,أرمن ارثوذكس,515,124,1,3,123
بيروت الأولى,المدور,المدرسة المركزية الارمنية الانجيلية - غرفة رقم 5,أرمن ارثوذكس,510,78,1,0,77
بيروت الأولى,المدور,المدرسة المركزية الارمنية الانجيلية - غرفة رقم 6,أرمن ارثوذكس,510,120,3,1,117
بيروت الأولى,المدور,المدرسة المركزية الارمنية الانجيلية - غرفة رقم 7,أرمن ارثوذكس,521,98,7,0,91
بيروت الأولى,المدور,المدرسة المركزية الارمنية الانجيلية - غرفة رقم 8,أرمن ارثوذكس,507,118,8,4,110
بيروت الأولى,المدور,المدرسة المركزية الارمنية الانجيلية - غرفة رقم 9,أرمن ارثوذكس,510,99,3,1,96
بيروت الأولى,المدور,شركة كهرباء لبنان - غرفة رقم 1,أرمن ارثوذكس,501,112,0,0,112
بيروت الأولى,المدور,شركة كهرباء لبنان - غرفة رقم 2,أرمن ارثوذكس,504,124,10,2,114
بيروت الأولى,المدور,شركة كهرباء لبنان - غرفة رقم 3,أرمن ارثوذكس,526,122,0,1,122
بيروت الأولى,المدور,شركة كهرباء لبنان - غرفة رقم 4,أرمن ارثوذكس,503,108,3,2,105
بيروت الأولى,المدور,شركة كهرباء لبنان - غرفة رقم 5,أرمن ارثوذكس,513,125,9,0,116
بيروت الأولى,المدور,شركة كهرباء لبنان - غرفة رقم 6,أرمن ارثوذكس,505,92,6,0,86
بيروت الأولى,المدور,مبنى البلدية - جانب فوج الأطفاء - جادة شارل حلو (البيت البتروني) بلوك A - غرفة رقم 1,سني,577,205,5,3,200
بيروت الأولى,المدور,مبنى البلدية - جانب فوج الأطفاء - جادة شارل حلو (البيت البتروني) بلوك A - غرفة رقم 10,سني,550,217,5,7,212
بيروت الأولى,المدور,مبنى البلدية - جانب فوج الأطفاء - جادة شارل حلو (البيت البتروني) بلوك A - غرفة رقم 11,سني,561,211,1,5,210
بيروت الأولى,المدور,مبنى البلدية - جانب فوج الأطفاء - جادة شارل حلو (البيت البتروني) بلوك A - غرفة رقم 12,شيعي,588,258,14,2,244
بيروت الأولى,المدور,مبنى البلدية - جانب فوج الأطفاء - جادة شارل حلو (البيت البتروني) بلوك A - غرفة رقم 2,سني,568,216,12,3,204
بيروت الأولى,المدور,مبنى البلدية - جانب فوج الأطفاء - جادة شارل حلو (البيت البتروني) بلوك A - غرفة رقم 3,سني,600,236,19,4,217
بيروت الأولى,المدور,مبنى البلدية - جانب فوج الأطفاء - جادة شارل حلو (البيت البتروني) بلوك A - غرفة رقم 4,سني,552,188,2,3,186
بيروت الأولى,المدور,مبنى البلدية - جانب فوج الأطفاء - جادة شارل حلو (البيت البتروني) بلوك A - غرفة رقم 5,سني,558,225,10,3,215
بيروت الأولى,المدور,مبنى البلدية - جانب فوج الأطفاء - جادة شارل حلو (البيت البتروني) بلوك A - غرفة رقم 6,سني,552,227,15,6,212
بيروت الأولى,المدور,مبنى البلدية - جانب فوج الأطفاء - جادة شارل حلو (البيت البتروني) بلوك A - غرفة رقم 7,سني,560,227,9,5,218
بيروت الأولى,المدور,مبنى البلدية - جانب فوج الأطفاء - جادة شارل حلو (البيت البتروني) بلوك A - غرفة رقم 8,سني,528,212,11,11,201
بيروت الأولى,المدور,مبنى البلدية - جانب فوج الأطفاء - جادة شارل حلو (البيت البتروني) بلوك A - غرفة رقم 9,سني,561,199,23,5,176
بيروت الأولى,المدور,مبنى البلدية - دائرة السير - غرفة رقم 1,ماروني,569,270,4,0,266
بيروت الأولى,المدور,مبنى البلدية - دائرة السير - غرفة رقم 2,ماروني,555,237,2,0,235
بيروت الأولى,المدور,مبنى البلدية - دائرة السير - غرفة رقم 3,ماروني,556,219,0,0,219
بيروت الأولى,المدور,مبنى البلدية - دائرة السير - غرفة رقم 4,ماروني,565,223,4,0,219
بيروت الأولى,المدور,محطة شارل الحلو بلوك A - غرفة رقم 1,أرمن ارثوذكس,524,100,0,0,100
بيروت الأولى,المدور,محطة شارل الحلو بلوك A - غرفة رقم 10,أرمن ارثوذكس,506,119,7,1,112
بيروت الأولى,المدور,محطة شارل الحلو بلوك A - غرفة رقم 11,أرمن ارثوذكس,517,153,9,1,144
بيروت الأولى,المدور,محطة شارل الحلو بلوك A - غرفة رقم 12,أرمن ارثوذكس,518,112,5,8,107
بيروت الأولى,المدور,محطة شارل الحلو بلوك A - غرفة رقم 13,أرمن ارثوذكس,517,122,7,0,115
بيروت الأولى,المدور,محطة شارل الحلو بلوك A - غرفة رقم 14,أرمن ارثوذكس,526,155,2,0,153
بيروت الأولى,المدور,محطة شارل الحلو بلوك A - غرفة رقم 15,أرمن ارثوذكس,511,128,1,0,127
بيروت الأولى,المدور,محطة شارل الحلو بلوك A - غرفة رقم 16,أرمن ارثوذكس,504,107,1,2,106
بيروت الأولى,المدور,محطة شارل الحلو بلوك A - غرفة رقم 2,أرمن ارثوذكس,539,104,3,0,101
بيروت الأولى,المدور,محطة شارل الحلو بلوك A - غرفة رقم 3,أرمن ارثوذكس,534,137,3,0,134
بيروت الأولى,المدور,محطة شارل الحلو بلوك A - غرفة رقم 4,أرمن ارثوذكس,540,133,1,2,132
بيروت الأولى,المدور,محطة شارل الحلو بلوك A - غرفة رقم 5,أرمن ارثوذكس,532,142,0,1,142
بيروت الأولى,المدور,محطة شارل الحلو بلوك A - غرفة رقم 6,أرمن ارثوذكس,519,79,0,2,79
بيروت الأولى,المدور,محطة شارل الحلو بلوك A - غرفة رقم 7,أرمن ارثوذكس,534,128,6,1,122
بيروت الأولى,المدور,محطة شارل الحلو بلوك A - غرفة رقم 8,أرمن ارثوذكس,513,123,3,1,120
بيروت الأولى,المدور,محطة شارل الحلو بلوك A - غرفة رقم 9,مختلف,524,150,8,0,142
بيروت الأولى,المدور,محطة شارل الحلو بلوك B - غرفة رقم 1,روم ارثوذكس,525,197,2,2,195
بيروت الأولى,المدور,محطة شارل الحلو بلوك B - غرفة رقم 10,مختلف,437,138,1,0,137
بيروت الأولى,المدور,محطة شارل الحلو بلوك B - غرفة رقم 2,مسيحي,529,154,3,0,151
بيروت الأولى,المدور,محطة شارل الحلو بلوك B - غرفة رقم 3,إنجيلي,457,104,0,1,104
بيروت الأولى,المدور,محطة شارل الحلو بلوك B - غرفة رقم 4,إنجيلي,458,77,1,1,76
بيروت الأولى,المدور,محطة شارل الحلو بلوك B - غرفة رقم 5,إنجيلي,515,87,3,0,84
بيروت الأولى,المدور,محطة شارل الحلو بلوك B - غرفة رقم 6,إنجيلي,494,67,2,0,65
بيروت الأولى,المدور,محطة شارل الحلو بلوك B - غرفة رقم 7,مسيحي,509,124,6,0,118
بيروت الأولى,المدور,محطة شارل الحلو بلوك B - غرفة رقم 8,مسيحي,554,143,12,0,131
بيروت الأولى,المدور,محطة شارل الحلو بلوك B - غرفة رقم 9,روم ارثوذكس,419,162,8,1,154
بيروت الأولى,المدور,مرآب البلدية بلوك A تجاه سليب كونفورت - غرفة رقم 1,أرمن كاثوليك,483,112,2,0,110
بيروت الأولى,المدور,مرآب البلدية بلوك A تجاه سليب كونفورت - غرفة رقم 2,أرمن كاثوليك,487,128,10,0,118
بيروت الأولى,المدور,مرآب البلدية بلوك A تجاه سليب كونفورت - غرفة رقم 3,أرمن كاثوليك,495,126,8,0,118
بيروت الأولى,المدور,مرآب البلدية بلوك A تجاه سليب كونفورت - غرفة رقم 4,روم كاثوليك,559,193,3,0,190
بيروت الأولى,المدور,مرآب البلدية بلوك A تجاه سليب كونفورت - غرفة رقم 5,روم كاثوليك,590,202,3,0,199
بيروت الأولى,المدور,مركز الاطفائية - جادة شارل الحلو - غرفة رقم 1,أرمن ارثوذكس,526,134,2,2,132
بيروت الأولى,المدور,مركز الاطفائية - جادة شارل الحلو - غرفة رقم 10,أرمن ارثوذكس,525,147,2,0,145
بيروت الأولى,المدور,مركز الاطفائية - جادة شارل الحلو - غرفة رقم 11,أرمن ارثوذكس,519,147,10,1,137
بيروت الأولى,المدور,مركز الاطفائية - جادة شارل الحلو - غرفة رقم 12,أرمن ارثوذكس,531,112,2,2,110
بيروت الأولى,المدور,مركز الاطفائية - جادة شارل الحلو - غرفة رقم 13,أرمن ارثوذكس,522,93,1,1,92
بيروت الأولى,المدور,مركز الاطفائية - جادة شارل الحلو - غرفة رقم 14,أرمن ارثوذكس,519,133,4,0,129
بيروت الأولى,المدور,مركز الاطفائية - جادة شارل الحلو - غرفة رقم 15,أرمن ارثوذكس,512,125,0,1,125
بيروت الأولى,المدور,مركز الاطفائية - جادة شارل الحلو - غرفة رقم 2,أرمن ارثوذكس,517,150,9,1,141
بيروت الأولى,المدور,مركز الاطفائية - جادة شارل الحلو - غرفة رقم 3,أرمن ارثوذكس,525,124,3,1,121
بيروت الأولى,المدور,مركز الاطفائية - جادة شارل الحلو - غرفة رقم 4,أرمن ارثوذكس,543,150,6,1,144
بيروت الأولى,المدور,مركز الاطفائية - جادة شارل الحلو - غرفة رقم 5,أرمن ارثوذكس,533,130,2,2,128
بيروت الأولى,المدور,مركز الاطفائية - جادة شارل الحلو - غرفة رقم 6,أرمن ارثوذكس,530,146,2,0,144
بيروت الأولى,المدور,مركز الاطفائية - جادة شارل الحلو - غرفة رقم 7,أرمن ارثوذكس,510,125,2,1,123
بيروت الأولى,المدور,مركز الاطفائية - جادة شارل الحلو - غرفة رقم 8,أرمن ارثوذكس,510,145,0,2,145
بيروت الأولى,المدور,مركز الاطفائية - جادة شارل الحلو - غرفة رقم 9,أرمن ارثوذكس,518,100,11,2,89
بيروت الأولى,موظفون,بيروت الأولى موظفون - مرأب بلدية بيروت - بلوك ب - غرفة رقم 1,مختلف,85,74,2,1,72
بيروت الثانية,الباشورة ,الباشورة - ابتدائية علي بن ابي طالب - شارع بشارة الخوري  - غرفة رقم 1,سني,626,317,19,2,298
بيروت الثانية,الباشورة ,الباشورة - ابتدائية علي بن ابي طالب - شارع بشارة الخوري  - غرفة رقم 10,سني,633,283,6,2,277
بيروت الثانية,الباشورة ,الباشورة - ابتدائية علي بن ابي طالب - شارع بشارة الخوري  - غرفة رقم 11,سني,611,267,9,2,258
بيروت الثانية,الباشورة ,الباشورة - ابتدائية علي بن ابي طالب - شارع بشارة الخوري  - غرفة رقم 12,سني,625,277,14,0,263
بيروت الثانية,الباشورة ,الباشورة - ابتدائية علي بن ابي طالب - شارع بشارة الخوري  - غرفة رقم 13,سني,631,246,3,0,243
بيروت الثانية,الباشورة ,الباشورة - ابتدائية علي بن ابي طالب - شارع بشارة الخوري  - غرفة رقم 14,سني,615,270,3,4,267
بيروت الثانية,الباشورة ,الباشورة - ابتدائية علي بن ابي طالب - شارع بشارة الخوري  - غرفة رقم 15,سني,649,351,6,5,345
بيروت الثانية,الباشورة ,الباشورة - ابتدائية علي بن ابي طالب - شارع بشارة الخوري  - غرفة رقم 16,سني,614,258,15,0,243
بيروت الثانية,الباشورة ,الباشورة - ابتدائية علي بن ابي طالب - شارع بشارة الخوري  - غرفة رقم 2,سني,631,246,4,2,242
بيروت الثانية,الباشورة ,الباشورة - ابتدائية علي بن ابي طالب - شارع بشارة الخوري  - غرفة رقم 3,سني,634,319,10,4,309
بيروت الثانية,الباشورة ,الباشورة - ابتدائية علي بن ابي طالب - شارع بشارة الخوري  - غرفة رقم 4,سني,617,340,10,5,330
بيروت الثانية,الباشورة ,الباشورة - ابتدائية علي بن ابي طالب - شارع بشارة الخوري  - غرفة رقم 5,سني,630,303,7,1,296
بيروت الثانية,الباشورة ,الباشورة - ابتدائية علي بن ابي طالب - شارع بشارة الخوري  - غرفة رقم 6,سني,617,274,4,1,270
بيروت الثانية,الباشورة ,الباشورة - ابتدائية علي بن ابي طالب - شارع بشارة الخوري  - غرفة رقم 7,سني,625,311,9,3,302
بيروت الثانية,الباشورة ,الباشورة - ابتدائية علي بن ابي طالب - شارع بشارة الخوري  - غرفة رقم 8,سني,616,315,8,1,307
بيروت الثانية,الباشورة ,الباشورة - ابتدائية علي بن ابي طالب - شارع بشارة الخوري  - غرفة رقم 9,سني,611,312,3,2,309
بيروت الثانية,الباشورة ,الباشورة - ثانوية الشهيد المفتي حسن خالد ( حوض الولاية – برج ابي حيدر)  - غرفة رقم 1,سني,628,319,7,2,312
بيروت الثانية,الباشورة ,الباشورة - ثانوية الشهيد المفتي حسن خالد ( حوض الولاية – برج ابي حيدر)  - غرفة رقم 10,ارمن ارثوذكس,573,41,1,1,40
بيروت الثانية,الباشورة ,الباشورة - ثانوية الشهيد المفتي حسن خالد ( حوض الولاية – برج ابي حيدر)  - غرفة رقم 11,مسيحي,556,33,0,0,33
بيروت الثانية,الباشورة ,الباشورة - ثانوية الشهيد المفتي حسن خالد ( حوض الولاية – برج ابي حيدر)  - غرفة رقم 12,مسيحي,552,74,0,0,74
بيروت الثانية,الباشورة ,الباشورة - ثانوية الشهيد المفتي حسن خالد ( حوض الولاية – برج ابي حيدر)  - غرفة رقم 2,سني,630,263,3,2,260
بيروت الثانية,الباشورة ,الباشورة - ثانوية الشهيد المفتي حسن خالد ( حوض الولاية – برج ابي حيدر)  - غرفة رقم 3,سني,636,337,10,1,327
بيروت الثانية,الباشورة ,الباشورة - ثانوية الشهيد المفتي حسن خالد ( حوض الولاية – برج ابي حيدر)  - غرفة رقم 4,سني,627,312,2,0,310
بيروت الثانية,الباشورة ,الباشورة - ثانوية الشهيد المفتي حسن خالد ( حوض الولاية – برج ابي حيدر)  - غرفة رقم 5,سني,619,305,7,2,298
بيروت الثانية,الباشورة ,الباشورة - ثانوية الشهيد المفتي حسن خالد ( حوض الولاية – برج ابي حيدر)  - غرفة رقم 6,سني,650,365,16,0,349
بيروت الثانية,الباشورة ,الباشورة - ثانوية الشهيد المفتي حسن خالد ( حوض الولاية – برج ابي حيدر)  - غرفة رقم 7,روم ارثوذكس,567,86,1,0,85
بيروت الثانية,الباشورة ,الباشورة - ثانوية الشهيد المفتي حسن خالد ( حوض الولاية – برج ابي حيدر)  - غرفة رقم 8,مسيحي,578,111,4,0,107
بيروت الثانية,الباشورة ,الباشورة - ثانوية الشهيد المفتي حسن خالد ( حوض الولاية – برج ابي حيدر)  - غرفة رقم 9,مسيحي,545,63,2,0,61
بيروت الثانية,الباشورة ,الباشورة - ثانوية المقاصد الاسلامية للبنات - شارع احمد طباره  - غرفة رقم 1,سني,607,295,9,1,286
بيروت الثانية,الباشورة ,الباشورة - ثانوية المقاصد الاسلامية للبنات - شارع احمد طباره  - غرفة رقم 10,سني,604,290,5,0,285
بيروت الثانية,الباشورة ,الباشورة - ثانوية المقاصد الاسلامية للبنات - شارع احمد طباره  - غرفة رقم 11,سني,606,310,8,1,302
بيروت الثانية,الباشورة ,الباشورة - ثانوية المقاصد الاسلامية للبنات - شارع احمد طباره  - غرفة رقم 12,سني,633,300,11,0,289
بيروت الثانية,الباشورة ,الباشورة - ثانوية المقاصد الاسلامية للبنات - شارع احمد طباره  - غرفة رقم 13,سني,605,272,19,1,253
بيروت الثانية,الباشورة ,الباشورة - ثانوية المقاصد الاسلامية للبنات - شارع احمد طباره  - غرفة رقم 14,سني,612,266,6,0,260
بيروت الثانية,الباشورة ,الباشورة - ثانوية المقاصد الاسلامية للبنات - شارع احمد طباره  - غرفة رقم 15,سني,605,212,10,0,202
بيروت الثانية,الباشورة ,الباشورة - ثانوية المقاصد الاسلامية للبنات - شارع احمد طباره  - غرفة رقم 16,سني,263,258,10,3,248
بيروت الثانية,الباشورة ,الباشورة - ثانوية المقاصد الاسلامية للبنات - شارع احمد طباره  - غرفة رقم 2,سني,602,266,10,2,256
بيروت الثانية,الباشورة ,الباشورة - ثانوية المقاصد الاسلامية للبنات - شارع احمد طباره  - غرفة رقم 3,سني,587,268,8,0,260
بيروت الثانية,الباشورة ,الباشورة - ثانوية المقاصد الاسلامية للبنات - شارع احمد طباره  - غرفة رقم 4,سني,612,311,17,0,294
بيروت الثانية,الباشورة ,الباشورة - ثانوية المقاصد الاسلامية للبنات - شارع احمد طباره  - غرفة رقم 5,سني,625,306,7,1,299
بيروت الثانية,الباشورة ,الباشورة - ثانوية المقاصد الاسلامية للبنات - شارع احمد طباره  - غرفة رقم 6,سني,637,306,18,0,288
بيروت الثانية,الباشورة ,الباشورة - ثانوية المقاصد الاسلامية للبنات - شارع احمد طباره  - غرفة رقم 7,سني,617,274,11,1,263
بيروت الثانية,الباشورة ,الباشورة - ثانوية المقاصد الاسلامية للبنات - شارع احمد طباره  - غرفة رقم 8,سني,625,318,5,4,313
بيروت الثانية,الباشورة ,الباشورة - ثانوية المقاصد الاسلامية للبنات - شارع احمد طباره  - غرفة رقم 9,سني,625,315,7,4,308
بيروت الثانية,الباشورة ,الباشورة - متوسطة المستقبل المختلطة – شارع احمد طبارة – البسطه التحتا  - غرفة رقم 1,شيعي,648,295,1,0,294
بيروت الثانية,الباشورة ,الباشورة - متوسطة المستقبل المختلطة – شارع احمد طبارة – البسطه التحتا  - غرفة رقم 10,شيعي,635,304,5,0,299
بيروت الثانية,الباشورة ,الباشورة - متوسطة المستقبل المختلطة – شارع احمد طبارة – البسطه التحتا  - غرفة رقم 11,شيعي,647,315,0,1,315
بيروت الثانية,الباشورة ,الباشورة - متوسطة المستقبل المختلطة – شارع احمد طبارة – البسطه التحتا  - غرفة رقم 12,شيعي,671,274,4,1,270
بيروت الثانية,الباشورة ,الباشورة - متوسطة المستقبل المختلطة – شارع احمد طبارة – البسطه التحتا  - غرفة رقم 13,شيعي,624,236,15,2,221
بيروت الثانية,الباشورة ,الباشورة - متوسطة المستقبل المختلطة – شارع احمد طبارة – البسطه التحتا  - غرفة رقم 14,شيعي,614,183,4,0,179
بيروت الثانية,الباشورة ,الباشورة - متوسطة المستقبل المختلطة – شارع احمد طبارة – البسطه التحتا  - غرفة رقم 2,شيعي,648,301,5,1,296
بيروت الثانية,الباشورة ,الباشورة - متوسطة المستقبل المختلطة – شارع احمد طبارة – البسطه التحتا  - غرفة رقم 3,شيعي,643,297,8,0,289
بيروت الثانية,الباشورة ,الباشورة - متوسطة المستقبل المختلطة – شارع احمد طبارة – البسطه التحتا  - غرفة رقم 4,شيعي,612,246,9,0,237
بيروت الثانية,الباشورة ,الباشورة - متوسطة المستقبل المختلطة – شارع احمد طبارة – البسطه التحتا  - غرفة رقم 5,شيعي,636,270,5,1,265
بيروت الثانية,الباشورة ,الباشورة - متوسطة المستقبل المختلطة – شارع احمد طبارة – البسطه التحتا  - غرفة رقم 6,شيعي,627,318,8,1,310
بيروت الثانية,الباشورة ,الباشورة - متوسطة المستقبل المختلطة – شارع احمد طبارة – البسطه التحتا  - غرفة رقم 7,شيعي,638,267,11,0,256
بيروت الثانية,الباشورة ,الباشورة - متوسطة المستقبل المختلطة – شارع احمد طبارة – البسطه التحتا  - غرفة رقم 8,شيعي,634,277,6,4,271
بيروت الثانية,الباشورة ,الباشورة - متوسطة المستقبل المختلطة – شارع احمد طبارة – البسطه التحتا  - غرفة رقم 9,شيعي,571,284,4,1,280
بيروت الثانية,الباشورة ,الباشورة - متوسطة بيروت العالية للبنات - شارع داود عمون  - غرفة رقم 1,شيعي,635,321,4,1,317
بيروت الثانية,الباشورة ,الباشورة - متوسطة بيروت العالية للبنات - شارع داود عمون  - غرفة رقم 10,شيعي,636,277,1,0,276
بيروت الثانية,الباشورة ,الباشورة - متوسطة بيروت العالية للبنات - شارع داود عمون  - غرفة رقم 11,شيعي,661,298,5,3,293
بيروت الثانية,الباشورة ,الباشورة - متوسطة بيروت العالية للبنات - شارع داود عمون  - غرفة رقم 12,شيعي,624,266,9,2,257
بيروت الثانية,الباشورة ,الباشورة - متوسطة بيروت العالية للبنات - شارع داود عمون  - غرفة رقم 13,شيعي,642,281,0,1,281
بيروت الثانية,الباشورة ,الباشورة - متوسطة بيروت العالية للبنات - شارع داود عمون  - غرفة رقم 14,شيعي,640,333,4,2,329
بيروت الثانية,الباشورة ,الباشورة - متوسطة بيروت العالية للبنات - شارع داود عمون  - غرفة رقم 15,شيعي,644,269,1,0,268
بيروت الثانية,الباشورة ,الباشورة - متوسطة بيروت العالية للبنات - شارع داود عمون  - غرفة رقم 16,شيعي,643,249,20,1,229
بيروت الثانية,الباشورة ,الباشورة - متوسطة بيروت العالية للبنات - شارع داود عمون  - غرفة رقم 2,شيعي,638,299,5,1,294
بيروت الثانية,الباشورة ,الباشورة - متوسطة بيروت العالية للبنات - شارع داود عمون  - غرفة رقم 3,شيعي,628,264,1,2,263
بيروت الثانية,الباشورة ,الباشورة - متوسطة بيروت العالية للبنات - شارع داود عمون  - غرفة رقم 4,شيعي,621,258,6,4,252
بيروت الثانية,الباشورة ,الباشورة - متوسطة بيروت العالية للبنات - شارع داود عمون  - غرفة رقم 5,شيعي,339,285,8,2,277
بيروت الثانية,الباشورة ,الباشورة - متوسطة بيروت العالية للبنات - شارع داود عمون  - غرفة رقم 6,شيعي,628,274,1,0,273
بيروت الثانية,الباشورة ,الباشورة - متوسطة بيروت العالية للبنات - شارع داود عمون  - غرفة رقم 7,شيعي,642,289,4,2,285
بيروت الثانية,الباشورة ,الباشورة - متوسطة بيروت العالية للبنات - شارع داود عمون  - غرفة رقم 8,شيعي,628,248,12,1,236
بيروت الثانية,الباشورة ,الباشورة - متوسطة بيروت العالية للبنات - شارع داود عمون  - غرفة رقم 9,شيعي,631,278,2,1,276
بيروت الثانية,الباشورة ,الباشورة - مدرسة حوض الولاية الاولى الرسمية المختلطة – شارع الخرسا البسطه التحتا  - غرفة رقم 1,شيعي,649,313,4,2,309
بيروت الثانية,الباشورة ,الباشورة - مدرسة حوض الولاية الاولى الرسمية المختلطة – شارع الخرسا البسطه التحتا  - غرفة رقم 10,مسيحي,605,70,0,1,70
بيروت الثانية,الباشورة ,الباشورة - مدرسة حوض الولاية الاولى الرسمية المختلطة – شارع الخرسا البسطه التحتا  - غرفة رقم 2,شيعي,628,326,2,0,324
بيروت الثانية,الباشورة ,الباشورة - مدرسة حوض الولاية الاولى الرسمية المختلطة – شارع الخرسا البسطه التحتا  - غرفة رقم 3,شيعي,574,320,1,3,319
بيروت الثانية,الباشورة ,الباشورة - مدرسة حوض الولاية الاولى الرسمية المختلطة – شارع الخرسا البسطه التحتا  - غرفة رقم 4,شيعي,671,269,2,1,267
بيروت الثانية,الباشورة ,الباشورة - مدرسة حوض الولاية الاولى الرسمية المختلطة – شارع الخرسا البسطه التحتا  - غرفة رقم 5,شيعي,652,206,5,0,201
بيروت الثانية,الباشورة ,الباشورة - مدرسة حوض الولاية الاولى الرسمية المختلطة – شارع الخرسا البسطه التحتا  - غرفة رقم 6,شيعي,273,222,1,1,221
بيروت الثانية,الباشورة ,الباشورة - مدرسة حوض الولاية الاولى الرسمية المختلطة – شارع الخرسا البسطه التحتا  - غرفة رقم 7,شيعي,568,93,1,0,92
بيروت الثانية,الباشورة ,الباشورة - مدرسة حوض الولاية الاولى الرسمية المختلطة – شارع الخرسا البسطه التحتا  - غرفة رقم 8,روم كاثوليك,577,84,2,0,82
بيروت الثانية,الباشورة ,الباشورة - مدرسة حوض الولاية الاولى الرسمية المختلطة – شارع الخرسا البسطه التحتا  - غرفة رقم 9,ماروني,546,54,1,0,53
بيروت الثانية,الباشورة ,الباشورة - مدرسة راس النبع الرسمية الثانية المختلطة-خندق الغميق  - غرفة رقم 1,شيعي,627,304,1,0,303
بيروت الثانية,الباشورة ,الباشورة - مدرسة راس النبع الرسمية الثانية المختلطة-خندق الغميق  - غرفة رقم 2,شيعي,627,283,0,1,283
بيروت الثانية,الباشورة ,الباشورة - مدرسة راس النبع الرسمية الثانية المختلطة-خندق الغميق  - غرفة رقم 3,شيعي,621,258,4,1,254
بيروت الثانية,الباشورة ,الباشورة - مدرسة راس النبع الرسمية الثانية المختلطة-خندق الغميق  - غرفة رقم 4,شيعي,619,248,6,0,242
بيروت الثانية,الباشورة ,الباشورة - مدرسة راس النبع الرسمية الثانية المختلطة-خندق الغميق  - غرفة رقم 5,شيعي,645,270,11,1,259
بيروت الثانية,الباشورة ,الباشورة - مدرسة راس النبع الرسمية الثانية المختلطة-خندق الغميق  - غرفة رقم 6,شيعي,617,292,13,3,279
بيروت الثانية,الباشورة ,الباشورة - مدرسة راس النبع الرسمية الثانية المختلطة-خندق الغميق  - غرفة رقم 7,شيعي,622,255,1,2,254
بيروت الثانية,الباشورة ,الباشورة - مدرسة راس النبع الرسمية الثانية المختلطة-خندق الغميق  - غرفة رقم 8,شيعي,613,291,3,0,288
بيروت الثانية,الباشورة ,الباشورة - مدرسة راس النبع الرسمية الثانية المختلطة-خندق الغميق  - غرفة رقم 9,شيعي,628,289,6,2,283
بيروت الثانية,المرفأ ,المرفأ - مبنى البلدية - جنب فوج الأطفاء - جادة شارل حلو (البيت البتروني)BLOCK B  - غرفة رقم 1,شيعي,579,238,5,0,233
بيروت الثانية,المرفأ ,المرفأ - مبنى البلدية - جنب فوج الأطفاء - جادة شارل حلو (البيت البتروني)BLOCK B  - غرفة رقم 10,سني,601,198,2,0,196
بيروت الثانية,المرفأ ,المرفأ - مبنى البلدية - جنب فوج الأطفاء - جادة شارل حلو (البيت البتروني)BLOCK B  - غرفة رقم 11,سني,616,252,10,1,242
بيروت الثانية,المرفأ ,المرفأ - مبنى البلدية - جنب فوج الأطفاء - جادة شارل حلو (البيت البتروني)BLOCK B  - غرفة رقم 12,سني,592,195,16,4,179
بيروت الثانية,المرفأ ,المرفأ - مبنى البلدية - جنب فوج الأطفاء - جادة شارل حلو (البيت البتروني)BLOCK B  - غرفة رقم 13,سني,622,205,3,2,202
بيروت الثانية,المرفأ ,المرفأ - مبنى البلدية - جنب فوج الأطفاء - جادة شارل حلو (البيت البتروني)BLOCK B  - غرفة رقم 14,سني,580,223,20,1,203
بيروت الثانية,المرفأ ,المرفأ - مبنى البلدية - جنب فوج الأطفاء - جادة شارل حلو (البيت البتروني)BLOCK B  - غرفة رقم 2,شيعي,582,302,6,0,296
بيروت الثانية,المرفأ ,المرفأ - مبنى البلدية - جنب فوج الأطفاء - جادة شارل حلو (البيت البتروني)BLOCK B  - غرفة رقم 3,شيعي,584,251,19,0,232
بيروت الثانية,المرفأ ,المرفأ - مبنى البلدية - جنب فوج الأطفاء - جادة شارل حلو (البيت البتروني)BLOCK B  - غرفة رقم 4,شيعي,587,320,3,3,317
بيروت الثانية,المرفأ ,المرفأ - مبنى البلدية - جنب فوج الأطفاء - جادة شارل حلو (البيت البتروني)BLOCK B  - غرفة رقم 5,مختلف,517,45,2,1,43
بيروت الثانية,المرفأ ,المرفأ - مبنى البلدية - جنب فوج الأطفاء - جادة شارل حلو (البيت البتروني)BLOCK B  - غرفة رقم 6,مختلف,569,40,1,1,39
بيروت الثانية,المرفأ ,المرفأ - مبنى البلدية - جنب فوج الأطفاء - جادة شارل حلو (البيت البتروني)BLOCK B  - غرفة رقم 7,سني,623,207,6,1,201
بيروت الثانية,المرفأ ,المرفأ - مبنى البلدية - جنب فوج الأطفاء - جادة شارل حلو (البيت البتروني)BLOCK B  - غرفة رقم 8,سني,601,169,3,1,166
بيروت الثانية,المرفأ ,المرفأ - مبنى البلدية - جنب فوج الأطفاء - جادة شارل حلو (البيت البتروني)BLOCK B  - غرفة رقم 9,سني,606,244,4,4,240
بيروت الثانية,المرفأ ,المرفأ - محطة شارل حلو بلوك B  - غرفة رقم 1,سني,606,167,0,1,167
بيروت الثانية,المرفأ ,المرفأ - محطة شارل حلو بلوك B  - غرفة رقم 2,سني,599,244,14,2,230
بيروت الثانية,المرفأ ,المرفأ - محطة شارل حلو بلوك B  - غرفة رقم 3,سني,612,201,15,5,186
بيروت الثانية,المرفأ ,المرفأ - محطة شارل حلو بلوك B  - غرفة رقم 4,مختلف,85,85,1,0,84
بيروت الثانية,المزرعة ,المزرعة - الثانوية العاملية المبنى الجنوبي - شارع عمر بن الخطاب  - غرفة رقم 1,شيعي,564,224,4,1,220
بيروت الثانية,المزرعة ,المزرعة - الثانوية العاملية المبنى الجنوبي - شارع عمر بن الخطاب  - غرفة رقم 10,ماروني,601,107,0,0,107
بيروت الثانية,المزرعة ,المزرعة - الثانوية العاملية المبنى الجنوبي - شارع عمر بن الخطاب  - غرفة رقم 11,مسيحي,565,49,0,1,49
بيروت الثانية,المزرعة ,المزرعة - الثانوية العاملية المبنى الجنوبي - شارع عمر بن الخطاب  - غرفة رقم 2,شيعي,588,249,5,0,244
بيروت الثانية,المزرعة ,المزرعة - الثانوية العاملية المبنى الجنوبي - شارع عمر بن الخطاب  - غرفة رقم 3,شيعي,609,276,6,7,270
بيروت الثانية,المزرعة ,المزرعة - الثانوية العاملية المبنى الجنوبي - شارع عمر بن الخطاب  - غرفة رقم 4,شيعي,600,273,10,1,263
بيروت الثانية,المزرعة ,المزرعة - الثانوية العاملية المبنى الجنوبي - شارع عمر بن الخطاب  - غرفة رقم 5,شيعي,632,242,4,1,238
بيروت الثانية,المزرعة ,المزرعة - الثانوية العاملية المبنى الجنوبي - شارع عمر بن الخطاب  - غرفة رقم 6,شيعي,612,255,6,1,249
بيروت الثانية,المزرعة ,المزرعة - الثانوية العاملية المبنى الجنوبي - شارع عمر بن الخطاب  - غرفة رقم 7,شيعي,606,257,1,1,256
بيروت الثانية,المزرعة ,المزرعة - الثانوية العاملية المبنى الجنوبي - شارع عمر بن الخطاب  - غرفة رقم 8,شيعي,644,275,2,5,273
بيروت الثانية,المزرعة ,المزرعة - الثانوية العاملية المبنى الجنوبي - شارع عمر بن الخطاب  - غرفة رقم 9,ماروني,553,87,2,1,85
بيروت الثانية,المزرعة ,المزرعة - العاملية للبنات- شارع المحمصاني  - غرفة رقم 1,سني,625,277,18,3,259
بيروت الثانية,المزرعة ,المزرعة - العاملية للبنات- شارع المحمصاني  - غرفة رقم 10,روم ارثوذكس,559,187,2,1,185
بيروت الثانية,المزرعة ,المزرعة - العاملية للبنات- شارع المحمصاني  - غرفة رقم 11,روم ارثوذكس,563,109,0,0,109
بيروت الثانية,المزرعة ,المزرعة - العاملية للبنات- شارع المحمصاني  - غرفة رقم 12,مسيحي,561,120,0,1,120
بيروت الثانية,المزرعة ,المزرعة - العاملية للبنات- شارع المحمصاني  - غرفة رقم 13,روم ارثوذكس,607,195,4,2,191
بيروت الثانية,المزرعة ,المزرعة - العاملية للبنات- شارع المحمصاني  - غرفة رقم 14,روم ارثوذكس,600,175,3,3,172
بيروت الثانية,المزرعة ,المزرعة - العاملية للبنات- شارع المحمصاني  - غرفة رقم 15,روم ارثوذكس,589,107,4,2,103
بيروت الثانية,المزرعة ,المزرعة - العاملية للبنات- شارع المحمصاني  - غرفة رقم 16,مسيحي,579,118,0,0,118
بيروت الثانية,المزرعة ,المزرعة - العاملية للبنات- شارع المحمصاني  - غرفة رقم 2,سني,628,308,19,4,289
بيروت الثانية,المزرعة ,المزرعة - العاملية للبنات- شارع المحمصاني  - غرفة رقم 3,سني,607,331,6,6,325
بيروت الثانية,المزرعة ,المزرعة - العاملية للبنات- شارع المحمصاني  - غرفة رقم 4,سني,648,341,17,5,324
بيروت الثانية,المزرعة ,المزرعة - العاملية للبنات- شارع المحمصاني  - غرفة رقم 5,سني,640,344,19,0,325
بيروت الثانية,المزرعة ,المزرعة - العاملية للبنات- شارع المحمصاني  - غرفة رقم 6,سني,640,318,9,4,309
بيروت الثانية,المزرعة ,المزرعة - العاملية للبنات- شارع المحمصاني  - غرفة رقم 7,سني,655,357,7,3,350
بيروت الثانية,المزرعة ,المزرعة - العاملية للبنات- شارع المحمصاني  - غرفة رقم 8,سني,640,370,8,3,362
بيروت الثانية,المزرعة ,المزرعة - العاملية للبنات- شارع المحمصاني  - غرفة رقم 9,روم ارثوذكس,572,194,6,1,188
بيروت الثانية,المزرعة ,المزرعة - المقاصد الاسلامية للبنين - آخر خط الحرج  - غرفة رقم 1,سني,605,271,6,2,265
بيروت الثانية,المزرعة ,المزرعة - المقاصد الاسلامية للبنين - آخر خط الحرج  - غرفة رقم 10,سني,641,282,9,1,273
بيروت الثانية,المزرعة ,المزرعة - المقاصد الاسلامية للبنين - آخر خط الحرج  - غرفة رقم 11,سني,606,273,7,0,266
بيروت الثانية,المزرعة ,المزرعة - المقاصد الاسلامية للبنين - آخر خط الحرج  - غرفة رقم 12,سني,608,325,14,1,311
بيروت الثانية,المزرعة ,المزرعة - المقاصد الاسلامية للبنين - آخر خط الحرج  - غرفة رقم 2,سني,611,299,9,1,290
بيروت الثانية,المزرعة ,المزرعة - المقاصد الاسلامية للبنين - آخر خط الحرج  - غرفة رقم 3,سني,616,269,12,2,257
بيروت الثانية,المزرعة ,المزرعة - المقاصد الاسلامية للبنين - آخر خط الحرج  - غرفة رقم 4,سني,629,309,14,2,295
بيروت الثانية,المزرعة ,المزرعة - المقاصد الاسلامية للبنين - آخر خط الحرج  - غرفة رقم 5,سني,630,298,12,4,286
بيروت الثانية,المزرعة ,المزرعة - المقاصد الاسلامية للبنين - آخر خط الحرج  - غرفة رقم 6,سني,603,293,10,1,283
بيروت الثانية,المزرعة ,المزرعة - المقاصد الاسلامية للبنين - آخر خط الحرج  - غرفة رقم 7,سني,615,266,5,1,261
بيروت الثانية,المزرعة ,المزرعة - المقاصد الاسلامية للبنين - آخر خط الحرج  - غرفة رقم 8,سني,650,262,13,4,249
بيروت الثانية,المزرعة ,المزرعة - المقاصد الاسلامية للبنين - آخر خط الحرج  - غرفة رقم 9,سني,610,231,4,1,227
بيروت الثانية,المزرعة ,المزرعة - ثانوية خالد بن الوليد المقاصد - الحرج  - غرفة رقم 1,سني,633,343,11,0,332
بيروت الثانية,المزرعة ,المزرعة - ثانوية خالد بن الوليد المقاصد - الحرج  - غرفة رقم 10,سني,594,269,10,2,259
بيروت الثانية,المزرعة ,المزرعة - ثانوية خالد بن الوليد المقاصد - الحرج  - غرفة رقم 11,سني,623,268,7,0,261
بيروت الثانية,المزرعة ,المزرعة - ثانوية خالد بن الوليد المقاصد - الحرج  - غرفة رقم 12,سني,597,274,7,1,267
بيروت الثانية,المزرعة ,المزرعة - ثانوية خالد بن الوليد المقاصد - الحرج  - غرفة رقم 13,سني,624,308,16,1,292
بيروت الثانية,المزرعة ,المزرعة - ثانوية خالد بن الوليد المقاصد - الحرج  - غرفة رقم 14,سني,623,326,11,0,315
بيروت الثانية,المزرعة ,المزرعة - ثانوية خالد بن الوليد المقاصد - الحرج  - غرفة رقم 15,سني,603,281,7,2,274
بيروت الثانية,المزرعة ,المزرعة - ثانوية خالد بن الوليد المقاصد - الحرج  - غرفة رقم 16,سني,592,247,10,1,237
بيروت الثانية,المزرعة ,المزرعة - ثانوية خالد بن الوليد المقاصد - الحرج  - غرفة رقم 2,سني,627,310,9,0,301
بيروت الثانية,المزرعة ,المزرعة - ثانوية خالد بن الوليد المقاصد - الحرج  - غرفة رقم 3,سني,631,305,9,1,296
بيروت الثانية,المزرعة ,المزرعة - ثانوية خالد بن الوليد المقاصد - الحرج  - غرفة رقم 4,سني,629,353,14,6,339
بيروت الثانية,المزرعة ,المزرعة - ثانوية خالد بن الوليد المقاصد - الحرج  - غرفة رقم 5,سني,595,340,10,2,330
بيروت الثانية,المزرعة ,المزرعة - ثانوية خالد بن الوليد المقاصد - الحرج  - غرفة رقم 6,سني,613,295,13,2,282
بيروت الثانية,المزرعة ,المزرعة - ثانوية خالد بن الوليد المقاصد - الحرج  - غرفة رقم 7,سني,599,285,2,0,283
بيروت الثانية,المزرعة ,المزرعة - ثانوية خالد بن الوليد المقاصد - الحرج  - غرفة رقم 8,سني,616,298,13,0,285
بيروت الثانية,المزرعة ,المزرعة - ثانوية خالد بن الوليد المقاصد - الحرج  - غرفة رقم 9,سني,626,290,10,0,280
بيروت الثانية,المزرعة ,المزرعة - ثانوية دولة الرئيس رياض الصلح المختلطة- رأس النبع  - غرفة رقم 1,سني,613,275,0,1,275
بيروت الثانية,المزرعة ,المزرعة - ثانوية دولة الرئيس رياض الصلح المختلطة- رأس النبع  - غرفة رقم 10,سني,613,265,0,1,265
بيروت الثانية,المزرعة ,المزرعة - ثانوية دولة الرئيس رياض الصلح المختلطة- رأس النبع  - غرفة رقم 11,سني,624,277,2,1,275
بيروت الثانية,المزرعة ,المزرعة - ثانوية دولة الرئيس رياض الصلح المختلطة- رأس النبع  - غرفة رقم 12,سني,600,262,5,2,257
بيروت الثانية,المزرعة ,المزرعة - ثانوية دولة الرئيس رياض الصلح المختلطة- رأس النبع  - غرفة رقم 13,سني,622,322,8,0,314
بيروت الثانية,المزرعة ,المزرعة - ثانوية دولة الرئيس رياض الصلح المختلطة- رأس النبع  - غرفة رقم 2,سني,611,249,2,1,247
بيروت الثانية,المزرعة ,المزرعة - ثانوية دولة الرئيس رياض الصلح المختلطة- رأس النبع  - غرفة رقم 3,سني,594,298,5,2,293
بيروت الثانية,المزرعة ,المزرعة - ثانوية دولة الرئيس رياض الصلح المختلطة- رأس النبع  - غرفة رقم 4,سني,615,316,5,0,311
بيروت الثانية,المزرعة ,المزرعة - ثانوية دولة الرئيس رياض الصلح المختلطة- رأس النبع  - غرفة رقم 5,سني,622,320,10,3,310
بيروت الثانية,المزرعة ,المزرعة - ثانوية دولة الرئيس رياض الصلح المختلطة- رأس النبع  - غرفة رقم 6,سني,599,295,1,4,294
بيروت الثانية,المزرعة ,المزرعة - ثانوية دولة الرئيس رياض الصلح المختلطة- رأس النبع  - غرفة رقم 7,سني,605,323,7,2,316
بيروت الثانية,المزرعة ,المزرعة - ثانوية دولة الرئيس رياض الصلح المختلطة- رأس النبع  - غرفة رقم 8,سني,617,263,4,3,259
بيروت الثانية,المزرعة ,المزرعة - ثانوية دولة الرئيس رياض الصلح المختلطة- رأس النبع  - غرفة رقم 9,سني,604,249,3,5,246
بيروت الثانية,المزرعة ,المزرعة - ثانوية عمر فروخ الرسمية للبنات مستديرة الكولا  - غرفة رقم 1,سني,601,300,6,6,294
بيروت الثانية,المزرعة ,المزرعة - ثانوية عمر فروخ الرسمية للبنات مستديرة الكولا  - غرفة رقم 10,سني,611,321,3,0,318
بيروت الثانية,المزرعة ,المزرعة - ثانوية عمر فروخ الرسمية للبنات مستديرة الكولا  - غرفة رقم 11,سني,605,327,14,0,313
بيروت الثانية,المزرعة ,المزرعة - ثانوية عمر فروخ الرسمية للبنات مستديرة الكولا  - غرفة رقم 12,سني,630,330,14,1,316
بيروت الثانية,المزرعة ,المزرعة - ثانوية عمر فروخ الرسمية للبنات مستديرة الكولا  - غرفة رقم 13,سني,620,364,9,2,355
بيروت الثانية,المزرعة ,المزرعة - ثانوية عمر فروخ الرسمية للبنات مستديرة الكولا  - غرفة رقم 14,سني,622,338,4,5,334
بيروت الثانية,المزرعة ,المزرعة - ثانوية عمر فروخ الرسمية للبنات مستديرة الكولا  - غرفة رقم 15,سني,618,332,3,2,329
بيروت الثانية,المزرعة ,المزرعة - ثانوية عمر فروخ الرسمية للبنات مستديرة الكولا  - غرفة رقم 16,سني,625,301,3,6,298
بيروت الثانية,المزرعة ,المزرعة - ثانوية عمر فروخ الرسمية للبنات مستديرة الكولا  - غرفة رقم 2,سني,622,270,4,0,266
بيروت الثانية,المزرعة ,المزرعة - ثانوية عمر فروخ الرسمية للبنات مستديرة الكولا  - غرفة رقم 3,سني,597,281,15,3,266
بيروت الثانية,المزرعة ,المزرعة - ثانوية عمر فروخ الرسمية للبنات مستديرة الكولا  - غرفة رقم 4,سني,624,313,12,0,301
بيروت الثانية,المزرعة ,المزرعة - ثانوية عمر فروخ الرسمية للبنات مستديرة الكولا  - غرفة رقم 5,سني,602,374,10,5,364
بيروت الثانية,المزرعة ,المزرعة - ثانوية عمر فروخ الرسمية للبنات مستديرة الكولا  - غرفة رقم 6,سني,609,330,4,7,326
بيروت الثانية,المزرعة ,المزرعة - ثانوية عمر فروخ الرسمية للبنات مستديرة الكولا  - غرفة رقم 7,سني,601,285,4,0,281
بيروت الثانية,المزرعة ,المزرعة - ثانوية عمر فروخ الرسمية للبنات مستديرة الكولا  - غرفة رقم 8,سني,629,372,18,4,354
بيروت الثانية,المزرعة ,المزرعة - ثانوية عمر فروخ الرسمية للبنات مستديرة الكولا  - غرفة رقم 9,سني,597,324,5,4,319
بيروت الثانية,المزرعة ,المزرعة - ثانوية فخر الدين المعني للبنات- شارع عبد الغني  - غرفة رقم 1,سني,606,274,12,4,262
بيروت الثانية,المزرعة ,المزرعة - ثانوية فخر الدين المعني للبنات- شارع عبد الغني  - غرفة رقم 10,سني,596,290,9,2,281
بيروت الثانية,المزرعة ,المزرعة - ثانوية فخر الدين المعني للبنات- شارع عبد الغني  - غرفة رقم 11,سني,616,269,4,2,265
بيروت الثانية,المزرعة ,المزرعة - ثانوية فخر الدين المعني للبنات- شارع عبد الغني  - غرفة رقم 12,سني,632,286,6,5,280
بيروت الثانية,المزرعة ,المزرعة - ثانوية فخر الدين المعني للبنات- شارع عبد الغني  - غرفة رقم 13,سني,605,275,4,1,271
بيروت الثانية,المزرعة ,المزرعة - ثانوية فخر الدين المعني للبنات- شارع عبد الغني  - غرفة رقم 14,سني,629,311,5,1,306
بيروت الثانية,المزرعة ,المزرعة - ثانوية فخر الدين المعني للبنات- شارع عبد الغني  - غرفة رقم 15,سني,592,308,3,1,305
بيروت الثانية,المزرعة ,المزرعة - ثانوية فخر الدين المعني للبنات- شارع عبد الغني  - غرفة رقم 16,سني,627,304,9,2,295
بيروت الثانية,المزرعة ,المزرعة - ثانوية فخر الدين المعني للبنات- شارع عبد الغني  - غرفة رقم 2,سني,614,303,10,1,293
بيروت الثانية,المزرعة ,المزرعة - ثانوية فخر الدين المعني للبنات- شارع عبد الغني  - غرفة رقم 3,سني,606,288,2,3,286
بيروت الثانية,المزرعة ,المزرعة - ثانوية فخر الدين المعني للبنات- شارع عبد الغني  - غرفة رقم 4,سني,623,274,33,3,241
بيروت الثانية,المزرعة ,المزرعة - ثانوية فخر الدين المعني للبنات- شارع عبد الغني  - غرفة رقم 5,سني,607,302,4,3,298
بيروت الثانية,المزرعة ,المزرعة - ثانوية فخر الدين المعني للبنات- شارع عبد الغني  - غرفة رقم 6,سني,621,323,9,0,314
بيروت الثانية,المزرعة ,المزرعة - ثانوية فخر الدين المعني للبنات- شارع عبد الغني  - غرفة رقم 7,سني,641,324,30,7,294
بيروت الثانية,المزرعة ,المزرعة - ثانوية فخر الدين المعني للبنات- شارع عبد الغني  - غرفة رقم 8,سني,608,250,4,0,246
بيروت الثانية,المزرعة ,المزرعة - ثانوية فخر الدين المعني للبنات- شارع عبد الغني  - غرفة رقم 9,سني,620,330,7,2,323
بيروت الثانية,المزرعة ,المزرعة - مدرسة الطريق الجديدة المتوسطة الرسمية الثانية للبنات - قصقص الحرج  - غرفة رقم 1,سني,618,201,10,2,191
بيروت الثانية,المزرعة ,المزرعة - مدرسة الطريق الجديدة المتوسطة الرسمية الثانية للبنات - قصقص الحرج  - غرفة رقم 10,سني,629,361,24,8,337
بيروت الثانية,المزرعة ,المزرعة - مدرسة الطريق الجديدة المتوسطة الرسمية الثانية للبنات - قصقص الحرج  - غرفة رقم 11,سني,618,357,9,6,348
بيروت الثانية,المزرعة ,المزرعة - مدرسة الطريق الجديدة المتوسطة الرسمية الثانية للبنات - قصقص الحرج  - غرفة رقم 12,سني,620,350,15,4,335
بيروت الثانية,المزرعة ,المزرعة - مدرسة الطريق الجديدة المتوسطة الرسمية الثانية للبنات - قصقص الحرج  - غرفة رقم 2,سني,618,236,2,3,234
بيروت الثانية,المزرعة ,المزرعة - مدرسة الطريق الجديدة المتوسطة الرسمية الثانية للبنات - قصقص الحرج  - غرفة رقم 3,سني,624,267,14,1,253
بيروت الثانية,المزرعة ,المزرعة - مدرسة الطريق الجديدة المتوسطة الرسمية الثانية للبنات - قصقص الحرج  - غرفة رقم 4,سني,612,279,5,2,274
بيروت الثانية,المزرعة ,المزرعة - مدرسة الطريق الجديدة المتوسطة الرسمية الثانية للبنات - قصقص الحرج  - غرفة رقم 5,سني,604,249,4,1,245
بيروت الثانية,المزرعة ,المزرعة - مدرسة الطريق الجديدة المتوسطة الرسمية الثانية للبنات - قصقص الحرج  - غرفة رقم 6,سني,617,261,8,0,253
بيروت الثانية,المزرعة ,المزرعة - مدرسة الطريق الجديدة المتوسطة الرسمية الثانية للبنات - قصقص الحرج  - غرفة رقم 7,سني,628,317,4,4,313
بيروت الثانية,المزرعة ,المزرعة - مدرسة الطريق الجديدة المتوسطة الرسمية الثانية للبنات - قصقص الحرج  - غرفة رقم 8,سني,624,324,9,3,315
بيروت الثانية,المزرعة ,المزرعة - مدرسة الطريق الجديدة المتوسطة الرسمية الثانية للبنات - قصقص الحرج  - غرفة رقم 9,سني,625,358,11,8,347
بيروت الثانية,المزرعة ,المزرعة - مدرسة النهضة الوطنية - شارع المزرعة  - غرفة رقم 1,سني,628,250,14,0,236
بيروت الثانية,المزرعة ,المزرعة - مدرسة النهضة الوطنية - شارع المزرعة  - غرفة رقم 2,سني,620,262,5,1,257
بيروت الثانية,المزرعة ,المزرعة - مدرسة النهضة الوطنية - شارع المزرعة  - غرفة رقم 3,سني,597,265,11,0,254
بيروت الثانية,المزرعة ,المزرعة - مدرسة النهضة الوطنية - شارع المزرعة  - غرفة رقم 4,سني,618,228,2,1,226
بيروت الثانية,المزرعة ,المزرعة - مدرسة النهضة الوطنية - شارع المزرعة  - غرفة رقم 5,سني,620,283,5,2,278
بيروت الثانية,المزرعة ,المزرعة - مدرسة النهضة الوطنية - شارع المزرعة  - غرفة رقم 6,سني,622,303,24,3,279
بيروت الثانية,المزرعة ,المزرعة - مدرسة رأس النبع الاولى للبنات ( عزيزة طيارة)  - غرفة رقم 1,سني,618,284,26,3,258
بيروت الثانية,المزرعة ,المزرعة - مدرسة رأس النبع الاولى للبنات ( عزيزة طيارة)  - غرفة رقم 2,سني,594,256,3,3,253
بيروت الثانية,المزرعة ,المزرعة - مدرسة رأس النبع الاولى للبنات ( عزيزة طيارة)  - غرفة رقم 3,سني,618,307,9,0,298
بيروت الثانية,المزرعة ,المزرعة - مدرسة رأس النبع الاولى للبنات ( عزيزة طيارة)  - غرفة رقم 4,سني,627,276,2,3,274
بيروت الثانية,المزرعة ,المزرعة - مدرسة رأس النبع الاولى للبنات ( عزيزة طيارة)  - غرفة رقم 5,سني,629,200,6,0,194
بيروت الثانية,المزرعة ,المزرعة - مدرسة رأس النبع الاولى للبنات ( عزيزة طيارة)  - غرفة رقم 6,سني,625,235,15,4,220
بيروت الثانية,المزرعة ,المزرعة - مدرسة راس النبع الرسمية الثانية للبنات- شارع محمد الحوت مقابل منازل الضباط  - غرفة رقم 1,سني,635,318,9,2,309
بيروت الثانية,المزرعة ,المزرعة - مدرسة راس النبع الرسمية الثانية للبنات- شارع محمد الحوت مقابل منازل الضباط  - غرفة رقم 10,سني,625,292,5,1,287
بيروت الثانية,المزرعة ,المزرعة - مدرسة راس النبع الرسمية الثانية للبنات- شارع محمد الحوت مقابل منازل الضباط  - غرفة رقم 11,سني,605,261,1,0,260
بيروت الثانية,المزرعة ,المزرعة - مدرسة راس النبع الرسمية الثانية للبنات- شارع محمد الحوت مقابل منازل الضباط  - غرفة رقم 12,سني,607,271,2,0,269
بيروت الثانية,المزرعة ,المزرعة - مدرسة راس النبع الرسمية الثانية للبنات- شارع محمد الحوت مقابل منازل الضباط  - غرفة رقم 13,سني,625,289,13,4,276
بيروت الثانية,المزرعة ,المزرعة - مدرسة راس النبع الرسمية الثانية للبنات- شارع محمد الحوت مقابل منازل الضباط  - غرفة رقم 14,سني,606,293,8,2,285
بيروت الثانية,المزرعة ,المزرعة - مدرسة راس النبع الرسمية الثانية للبنات- شارع محمد الحوت مقابل منازل الضباط  - غرفة رقم 2,سني,608,295,5,4,290
بيروت الثانية,المزرعة ,المزرعة - مدرسة راس النبع الرسمية الثانية للبنات- شارع محمد الحوت مقابل منازل الضباط  - غرفة رقم 3,سني,623,310,6,0,304
بيروت الثانية,المزرعة ,المزرعة - مدرسة راس النبع الرسمية الثانية للبنات- شارع محمد الحوت مقابل منازل الضباط  - غرفة رقم 4,سني,628,267,5,2,262
بيروت الثانية,المزرعة ,المزرعة - مدرسة راس النبع الرسمية الثانية للبنات- شارع محمد الحوت مقابل منازل الضباط  - غرفة رقم 5,سني,631,318,8,2,310
بيروت الثانية,المزرعة ,المزرعة - مدرسة راس النبع الرسمية الثانية للبنات- شارع محمد الحوت مقابل منازل الضباط  - غرفة رقم 6,سني,613,278,2,0,276
بيروت الثانية,المزرعة ,المزرعة - مدرسة راس النبع الرسمية الثانية للبنات- شارع محمد الحوت مقابل منازل الضباط  - غرفة رقم 7,سني,618,292,17,1,275
بيروت الثانية,المزرعة ,المزرعة - مدرسة راس النبع الرسمية الثانية للبنات- شارع محمد الحوت مقابل منازل الضباط  - غرفة رقم 8,سني,616,329,7,2,322
بيروت الثانية,المزرعة ,المزرعة - مدرسة راس النبع الرسمية الثانية للبنات- شارع محمد الحوت مقابل منازل الضباط  - غرفة رقم 9,سني,641,295,23,1,272
بيروت الثانية,المزرعة ,المزرعة - مدرسة عمر الزعني المتوسطة الرسمية المختلطة – الملعب البلدي  - غرفة رقم 1,سني,619,308,7,5,301
بيروت الثانية,المزرعة ,المزرعة - مدرسة عمر الزعني المتوسطة الرسمية المختلطة – الملعب البلدي  - غرفة رقم 10,سني,625,301,7,5,294
بيروت الثانية,المزرعة ,المزرعة - مدرسة عمر الزعني المتوسطة الرسمية المختلطة – الملعب البلدي  - غرفة رقم 11,سني,630,283,20,2,263
بيروت الثانية,المزرعة ,المزرعة - مدرسة عمر الزعني المتوسطة الرسمية المختلطة – الملعب البلدي  - غرفة رقم 12,سني,659,381,7,1,374
بيروت الثانية,المزرعة ,المزرعة - مدرسة عمر الزعني المتوسطة الرسمية المختلطة – الملعب البلدي  - غرفة رقم 13,سني,603,308,5,1,303
بيروت الثانية,المزرعة ,المزرعة - مدرسة عمر الزعني المتوسطة الرسمية المختلطة – الملعب البلدي  - غرفة رقم 14,سني,629,318,17,3,301
بيروت الثانية,المزرعة ,المزرعة - مدرسة عمر الزعني المتوسطة الرسمية المختلطة – الملعب البلدي  - غرفة رقم 2,سني,634,364,25,0,339
بيروت الثانية,المزرعة ,المزرعة - مدرسة عمر الزعني المتوسطة الرسمية المختلطة – الملعب البلدي  - غرفة رقم 3,سني,609,324,13,5,311
بيروت الثانية,المزرعة ,المزرعة - مدرسة عمر الزعني المتوسطة الرسمية المختلطة – الملعب البلدي  - غرفة رقم 4,سني,628,284,6,3,278
بيروت الثانية,المزرعة ,المزرعة - مدرسة عمر الزعني المتوسطة الرسمية المختلطة – الملعب البلدي  - غرفة رقم 5,سني,620,283,13,0,270
بيروت الثانية,المزرعة ,المزرعة - مدرسة عمر الزعني المتوسطة الرسمية المختلطة – الملعب البلدي  - غرفة رقم 6,سني,613,303,25,3,278
بيروت الثانية,المزرعة ,المزرعة - مدرسة عمر الزعني المتوسطة الرسمية المختلطة – الملعب البلدي  - غرفة رقم 7,سني,605,278,17,1,261
بيروت الثانية,المزرعة ,المزرعة - مدرسة عمر الزعني المتوسطة الرسمية المختلطة – الملعب البلدي  - غرفة رقم 8,سني,626,334,5,3,329
بيروت الثانية,المزرعة ,المزرعة - مدرسة عمر الزعني المتوسطة الرسمية المختلطة – الملعب البلدي  - غرفة رقم 9,سني,618,334,6,2,328
بيروت الثانية,المصيطبة ,المصيطبة - ثانوية الدكتور حسن صعب الرسمية سابقاً رينيه معوض - رمل الظريف  - غرفة رقم 1,شيعي,608,240,1,0,239
بيروت الثانية,المصيطبة ,المصيطبة - ثانوية الدكتور حسن صعب الرسمية سابقاً رينيه معوض - رمل الظريف  - غرفة رقم 10,درزي,624,234,8,0,226
بيروت الثانية,المصيطبة ,المصيطبة - ثانوية الدكتور حسن صعب الرسمية سابقاً رينيه معوض - رمل الظريف  - غرفة رقم 11,مختلف,583,174,0,0,174
بيروت الثانية,المصيطبة ,المصيطبة - ثانوية الدكتور حسن صعب الرسمية سابقاً رينيه معوض - رمل الظريف  - غرفة رقم 12,ماروني,566,131,0,2,131
بيروت الثانية,المصيطبة ,المصيطبة - ثانوية الدكتور حسن صعب الرسمية سابقاً رينيه معوض - رمل الظريف  - غرفة رقم 2,شيعي,6370,289,12,0,277
بيروت الثانية,المصيطبة ,المصيطبة - ثانوية الدكتور حسن صعب الرسمية سابقاً رينيه معوض - رمل الظريف  - غرفة رقم 3,شيعي,631,288,9,2,279
بيروت الثانية,المصيطبة ,المصيطبة - ثانوية الدكتور حسن صعب الرسمية سابقاً رينيه معوض - رمل الظريف  - غرفة رقم 4,شيعي,625,274,3,0,271
بيروت الثانية,المصيطبة ,المصيطبة - ثانوية الدكتور حسن صعب الرسمية سابقاً رينيه معوض - رمل الظريف  - غرفة رقم 5,شيعي,625,278,2,0,276
بيروت الثانية,المصيطبة ,المصيطبة - ثانوية الدكتور حسن صعب الرسمية سابقاً رينيه معوض - رمل الظريف  - غرفة رقم 6,مختلف,603,175,4,1,171
بيروت الثانية,المصيطبة ,المصيطبة - ثانوية الدكتور حسن صعب الرسمية سابقاً رينيه معوض - رمل الظريف  - غرفة رقم 7,درزي,588,280,6,1,274
بيروت الثانية,المصيطبة ,المصيطبة - ثانوية الدكتور حسن صعب الرسمية سابقاً رينيه معوض - رمل الظريف  - غرفة رقم 8,درزي,587,243,8,2,235
بيروت الثانية,المصيطبة ,المصيطبة - ثانوية الدكتور حسن صعب الرسمية سابقاً رينيه معوض - رمل الظريف  - غرفة رقم 9,درزي,573,234,6,2,228
بيروت الثانية,المصيطبة ,المصيطبة - ثانوية جبران اندراوس تويني- مجمع المدارس - شارع احمد الأسعد - مقابل المدينة الرياضية  - غرفة رقم 1,سني,640,368,31,9,337
بيروت الثانية,المصيطبة ,المصيطبة - ثانوية جبران اندراوس تويني- مجمع المدارس - شارع احمد الأسعد - مقابل المدينة الرياضية  - غرفة رقم 10,سني,604,288,7,1,281
بيروت الثانية,المصيطبة ,المصيطبة - ثانوية جبران اندراوس تويني- مجمع المدارس - شارع احمد الأسعد - مقابل المدينة الرياضية  - غرفة رقم 11,سني,622,267,0,0,267
بيروت الثانية,المصيطبة ,المصيطبة - ثانوية جبران اندراوس تويني- مجمع المدارس - شارع احمد الأسعد - مقابل المدينة الرياضية  - غرفة رقم 12,سني,624,282,11,2,271
بيروت الثانية,المصيطبة ,المصيطبة - ثانوية جبران اندراوس تويني- مجمع المدارس - شارع احمد الأسعد - مقابل المدينة الرياضية  - غرفة رقم 13,سني,605,251,12,0,239
بيروت الثانية,المصيطبة ,المصيطبة - ثانوية جبران اندراوس تويني- مجمع المدارس - شارع احمد الأسعد - مقابل المدينة الرياضية  - غرفة رقم 2,سني,607,302,4,3,298
بيروت الثانية,المصيطبة ,المصيطبة - ثانوية جبران اندراوس تويني- مجمع المدارس - شارع احمد الأسعد - مقابل المدينة الرياضية  - غرفة رقم 3,سني,598,261,2,5,259
بيروت الثانية,المصيطبة ,المصيطبة - ثانوية جبران اندراوس تويني- مجمع المدارس - شارع احمد الأسعد - مقابل المدينة الرياضية  - غرفة رقم 4,سني,614,282,15,3,267
بيروت الثانية,المصيطبة ,المصيطبة - ثانوية جبران اندراوس تويني- مجمع المدارس - شارع احمد الأسعد - مقابل المدينة الرياضية  - غرفة رقم 5,سني,624,269,2,4,267
بيروت الثانية,المصيطبة ,المصيطبة - ثانوية جبران اندراوس تويني- مجمع المدارس - شارع احمد الأسعد - مقابل المدينة الرياضية  - غرفة رقم 6,سني,600,279,7,2,272
بيروت الثانية,المصيطبة ,المصيطبة - ثانوية جبران اندراوس تويني- مجمع المدارس - شارع احمد الأسعد - مقابل المدينة الرياضية  - غرفة رقم 7,سني,614,287,11,1,276
بيروت الثانية,المصيطبة ,المصيطبة - ثانوية جبران اندراوس تويني- مجمع المدارس - شارع احمد الأسعد - مقابل المدينة الرياضية  - غرفة رقم 8,سني,615,299,3,2,296
بيروت الثانية,المصيطبة ,المصيطبة - ثانوية جبران اندراوس تويني- مجمع المدارس - شارع احمد الأسعد - مقابل المدينة الرياضية  - غرفة رقم 9,سني,627,289,0,0,289
بيروت الثانية,المصيطبة ,المصيطبة - ثانوية خديجة الكبرى شارع بني معروف قرب جامع القصار  - غرفة رقم 1,سني,631,294,9,1,285
بيروت الثانية,المصيطبة ,المصيطبة - ثانوية خديجة الكبرى شارع بني معروف قرب جامع القصار  - غرفة رقم 10,سني,610,296,7,0,289
بيروت الثانية,المصيطبة ,المصيطبة - ثانوية خديجة الكبرى شارع بني معروف قرب جامع القصار  - غرفة رقم 11,سني,628,315,6,5,309
بيروت الثانية,المصيطبة ,المصيطبة - ثانوية خديجة الكبرى شارع بني معروف قرب جامع القصار  - غرفة رقم 12,سني,611,287,7,1,280
بيروت الثانية,المصيطبة ,المصيطبة - ثانوية خديجة الكبرى شارع بني معروف قرب جامع القصار  - غرفة رقم 13,سني,627,280,22,3,258
بيروت الثانية,المصيطبة ,المصيطبة - ثانوية خديجة الكبرى شارع بني معروف قرب جامع القصار  - غرفة رقم 14,سني,619,298,6,0,292
بيروت الثانية,المصيطبة ,المصيطبة - ثانوية خديجة الكبرى شارع بني معروف قرب جامع القصار  - غرفة رقم 15,سني,613,307,10,1,297
بيروت الثانية,المصيطبة ,المصيطبة - ثانوية خديجة الكبرى شارع بني معروف قرب جامع القصار  - غرفة رقم 16,سني,634,296,7,2,289
بيروت الثانية,المصيطبة ,المصيطبة - ثانوية خديجة الكبرى شارع بني معروف قرب جامع القصار  - غرفة رقم 2,سني,628,290,7,1,283
بيروت الثانية,المصيطبة ,المصيطبة - ثانوية خديجة الكبرى شارع بني معروف قرب جامع القصار  - غرفة رقم 3,سني,609,302,8,4,294
بيروت الثانية,المصيطبة ,المصيطبة - ثانوية خديجة الكبرى شارع بني معروف قرب جامع القصار  - غرفة رقم 4,سني,630,303,2,4,301
بيروت الثانية,المصيطبة ,المصيطبة - ثانوية خديجة الكبرى شارع بني معروف قرب جامع القصار  - غرفة رقم 5,سني,629,283,2,1,281
بيروت الثانية,المصيطبة ,المصيطبة - ثانوية خديجة الكبرى شارع بني معروف قرب جامع القصار  - غرفة رقم 6,سني,627,326,11,0,315
بيروت الثانية,المصيطبة ,المصيطبة - ثانوية خديجة الكبرى شارع بني معروف قرب جامع القصار  - غرفة رقم 7,سني,648,289,4,3,285
بيروت الثانية,المصيطبة ,المصيطبة - ثانوية خديجة الكبرى شارع بني معروف قرب جامع القصار  - غرفة رقم 8,سني,610,286,6,1,280
بيروت الثانية,المصيطبة ,المصيطبة - ثانوية خديجة الكبرى شارع بني معروف قرب جامع القصار  - غرفة رقم 9,سني,595,280,7,2,273
بيروت الثانية,المصيطبة ,المصيطبة - متوسطة الابتهاج قدوره – مقابل المدينة الرياضية  - غرفة رقم 1,سني,602,277,6,0,271
بيروت الثانية,المصيطبة ,المصيطبة - متوسطة الابتهاج قدوره – مقابل المدينة الرياضية  - غرفة رقم 10,سني,620,303,0,3,303
بيروت الثانية,المصيطبة ,المصيطبة - متوسطة الابتهاج قدوره – مقابل المدينة الرياضية  - غرفة رقم 11,سني,635,302,7,1,295
بيروت الثانية,المصيطبة ,المصيطبة - متوسطة الابتهاج قدوره – مقابل المدينة الرياضية  - غرفة رقم 12,سني,599,297,10,1,287
بيروت الثانية,المصيطبة ,المصيطبة - متوسطة الابتهاج قدوره – مقابل المدينة الرياضية  - غرفة رقم 13,سني,623,240,8,1,232
بيروت الثانية,المصيطبة ,المصيطبة - متوسطة الابتهاج قدوره – مقابل المدينة الرياضية  - غرفة رقم 14,سني,616,288,5,1,283
بيروت الثانية,المصيطبة ,المصيطبة - متوسطة الابتهاج قدوره – مقابل المدينة الرياضية  - غرفة رقم 15,سني,636,300,1,0,299
بيروت الثانية,المصيطبة ,المصيطبة - متوسطة الابتهاج قدوره – مقابل المدينة الرياضية  - غرفة رقم 16,سني,616,318,12,5,306
بيروت الثانية,المصيطبة ,المصيطبة - متوسطة الابتهاج قدوره – مقابل المدينة الرياضية  - غرفة رقم 2,سني,626,288,12,1,276
بيروت الثانية,المصيطبة ,المصيطبة - متوسطة الابتهاج قدوره – مقابل المدينة الرياضية  - غرفة رقم 3,سني,633,298,11,1,287
بيروت الثانية,المصيطبة ,المصيطبة - متوسطة الابتهاج قدوره – مقابل المدينة الرياضية  - غرفة رقم 4,سني,627,290,5,1,285
بيروت الثانية,المصيطبة ,المصيطبة - متوسطة الابتهاج قدوره – مقابل المدينة الرياضية  - غرفة رقم 5,سني,610,266,4,2,262
بيروت الثانية,المصيطبة ,المصيطبة - متوسطة الابتهاج قدوره – مقابل المدينة الرياضية  - غرفة رقم 6,سني,620,287,1,4,286
بيروت الثانية,المصيطبة ,المصيطبة - متوسطة الابتهاج قدوره – مقابل المدينة الرياضية  - غرفة رقم 7,سني,610,235,7,5,228
بيروت الثانية,المصيطبة ,المصيطبة - متوسطة الابتهاج قدوره – مقابل المدينة الرياضية  - غرفة رقم 8,سني,620,304,2,2,302
بيروت الثانية,المصيطبة ,المصيطبة - متوسطة الابتهاج قدوره – مقابل المدينة الرياضية  - غرفة رقم 9,سني,634,316,15,5,301
بيروت الثانية,المصيطبة ,المصيطبة - مدرسة الارشاد للبنات - برج ابي حيدر  - غرفة رقم 1,سني,597,280,18,1,262
بيروت الثانية,المصيطبة ,المصيطبة - مدرسة الارشاد للبنات - برج ابي حيدر  - غرفة رقم 10,سني,642,328,9,8,319
بيروت الثانية,المصيطبة ,المصيطبة - مدرسة الارشاد للبنات - برج ابي حيدر  - غرفة رقم 11,سني,665,355,9,6,346
بيروت الثانية,المصيطبة ,المصيطبة - مدرسة الارشاد للبنات - برج ابي حيدر  - غرفة رقم 12,سني,644,301,31,7,270
بيروت الثانية,المصيطبة ,المصيطبة - مدرسة الارشاد للبنات - برج ابي حيدر  - غرفة رقم 13,سني,628,301,30,0,271
بيروت الثانية,المصيطبة ,المصيطبة - مدرسة الارشاد للبنات - برج ابي حيدر  - غرفة رقم 14,سني,637,272,23,2,249
بيروت الثانية,المصيطبة ,المصيطبة - مدرسة الارشاد للبنات - برج ابي حيدر  - غرفة رقم 15,سني,645,269,9,4,260
بيروت الثانية,المصيطبة ,المصيطبة - مدرسة الارشاد للبنات - برج ابي حيدر  - غرفة رقم 16,أرمن ارثوذكس,562,69,0,2,69
بيروت الثانية,المصيطبة ,المصيطبة - مدرسة الارشاد للبنات - برج ابي حيدر  - غرفة رقم 2,سني,615,250,9,4,241
بيروت الثانية,المصيطبة ,المصيطبة - مدرسة الارشاد للبنات - برج ابي حيدر  - غرفة رقم 3,سني,627,272,5,1,267
بيروت الثانية,المصيطبة ,المصيطبة - مدرسة الارشاد للبنات - برج ابي حيدر  - غرفة رقم 4,سني,593,253,6,2,247
بيروت الثانية,المصيطبة ,المصيطبة - مدرسة الارشاد للبنات - برج ابي حيدر  - غرفة رقم 5,سني,635,259,14,0,245
بيروت الثانية,المصيطبة ,المصيطبة - مدرسة الارشاد للبنات - برج ابي حيدر  - غرفة رقم 6,سني,637,255,13,6,242
بيروت الثانية,المصيطبة ,المصيطبة - مدرسة الارشاد للبنات - برج ابي حيدر  - غرفة رقم 7,سني,615,191,6,1,185
بيروت الثانية,المصيطبة ,المصيطبة - مدرسة الارشاد للبنات - برج ابي حيدر  - غرفة رقم 8,سني,611,238,2,2,236
بيروت الثانية,المصيطبة ,المصيطبة - مدرسة الارشاد للبنات - برج ابي حيدر  - غرفة رقم 9,سني,650,219,7,4,212
بيروت الثانية,المصيطبة ,المصيطبة - مدرسة رمل الظريف المختلطة الرسمية - شارع الزيدانية  - غرفة رقم 1,شيعي,624,286,7,5,279
بيروت الثانية,المصيطبة ,المصيطبة - مدرسة رمل الظريف المختلطة الرسمية - شارع الزيدانية  - غرفة رقم 10,شيعي,622,298,3,1,295
بيروت الثانية,المصيطبة ,المصيطبة - مدرسة رمل الظريف المختلطة الرسمية - شارع الزيدانية  - غرفة رقم 11,شيعي,642,287,3,3,284
بيروت الثانية,المصيطبة ,المصيطبة - مدرسة رمل الظريف المختلطة الرسمية - شارع الزيدانية  - غرفة رقم 12,شيعي,249,249,6,1,243
بيروت الثانية,المصيطبة ,المصيطبة - مدرسة رمل الظريف المختلطة الرسمية - شارع الزيدانية  - غرفة رقم 13,شيعي,615,246,0,2,246
بيروت الثانية,المصيطبة ,المصيطبة - مدرسة رمل الظريف المختلطة الرسمية - شارع الزيدانية  - غرفة رقم 2,شيعي,645,251,11,1,240
بيروت الثانية,المصيطبة ,المصيطبة - مدرسة رمل الظريف المختلطة الرسمية - شارع الزيدانية  - غرفة رقم 3,شيعي,592,260,5,4,255
بيروت الثانية,المصيطبة ,المصيطبة - مدرسة رمل الظريف المختلطة الرسمية - شارع الزيدانية  - غرفة رقم 4,شيعي,629,297,3,2,294
بيروت الثانية,المصيطبة ,المصيطبة - مدرسة رمل الظريف المختلطة الرسمية - شارع الزيدانية  - غرفة رقم 5,شيعي,625,279,4,2,275
بيروت الثانية,المصيطبة ,المصيطبة - مدرسة رمل الظريف المختلطة الرسمية - شارع الزيدانية  - غرفة رقم 6,شيعي,640,290,3,0,287
بيروت الثانية,المصيطبة ,المصيطبة - مدرسة رمل الظريف المختلطة الرسمية - شارع الزيدانية  - غرفة رقم 7,شيعي,604,290,5,0,285
بيروت الثانية,المصيطبة ,المصيطبة - مدرسة رمل الظريف المختلطة الرسمية - شارع الزيدانية  - غرفة رقم 8,شيعي,622,284,5,3,279
بيروت الثانية,المصيطبة ,المصيطبة - مدرسة رمل الظريف المختلطة الرسمية - شارع الزيدانية  - غرفة رقم 9,شيعي,539,317,2,2,315
بيروت الثانية,المصيطبة ,المصيطبة - مدرسة عمر فاخوري الابتدائية المختلطة مقابل المدينة الرياضية  - غرفة رقم 1,سني,602,280,11,0,269
بيروت الثانية,المصيطبة ,المصيطبة - مدرسة عمر فاخوري الابتدائية المختلطة مقابل المدينة الرياضية  - غرفة رقم 10,سني,611,285,6,0,279
بيروت الثانية,المصيطبة ,المصيطبة - مدرسة عمر فاخوري الابتدائية المختلطة مقابل المدينة الرياضية  - غرفة رقم 11,سني,620,210,0,2,210
بيروت الثانية,المصيطبة ,المصيطبة - مدرسة عمر فاخوري الابتدائية المختلطة مقابل المدينة الرياضية  - غرفة رقم 12,سني,640,216,3,1,213
بيروت الثانية,المصيطبة ,المصيطبة - مدرسة عمر فاخوري الابتدائية المختلطة مقابل المدينة الرياضية  - غرفة رقم 13,سني,600,194,8,0,186
بيروت الثانية,المصيطبة ,المصيطبة - مدرسة عمر فاخوري الابتدائية المختلطة مقابل المدينة الرياضية  - غرفة رقم 14,سني,618,276,7,0,269
بيروت الثانية,المصيطبة ,المصيطبة - مدرسة عمر فاخوري الابتدائية المختلطة مقابل المدينة الرياضية  - غرفة رقم 15,سني,634,320,16,7,304
بيروت الثانية,المصيطبة ,المصيطبة - مدرسة عمر فاخوري الابتدائية المختلطة مقابل المدينة الرياضية  - غرفة رقم 2,سني,621,305,9,1,296
بيروت الثانية,المصيطبة ,المصيطبة - مدرسة عمر فاخوري الابتدائية المختلطة مقابل المدينة الرياضية  - غرفة رقم 3,سني,611,284,12,6,272
بيروت الثانية,المصيطبة ,المصيطبة - مدرسة عمر فاخوري الابتدائية المختلطة مقابل المدينة الرياضية  - غرفة رقم 4,سني,611,274,2,3,272
بيروت الثانية,المصيطبة ,المصيطبة - مدرسة عمر فاخوري الابتدائية المختلطة مقابل المدينة الرياضية  - غرفة رقم 5,سني,631,304,4,4,300
بيروت الثانية,المصيطبة ,المصيطبة - مدرسة عمر فاخوري الابتدائية المختلطة مقابل المدينة الرياضية  - غرفة رقم 6,سني,642,339,8,2,331
بيروت الثانية,المصيطبة ,المصيطبة - مدرسة عمر فاخوري الابتدائية المختلطة مقابل المدينة الرياضية  - غرفة رقم 7,سني,605,278,3,3,275
بيروت الثانية,المصيطبة ,المصيطبة - مدرسة عمر فاخوري الابتدائية المختلطة مقابل المدينة الرياضية  - غرفة رقم 8,سني,620,273,0,2,273
بيروت الثانية,المصيطبة ,المصيطبة - مدرسة عمر فاخوري الابتدائية المختلطة مقابل المدينة الرياضية  - غرفة رقم 9,سني,614,260,7,3,253
بيروت الثانية,المصيطبة ,المصيطبة - مدرسة مار الياس بطينا  - غرفة رقم 1,روم ارثوذكس,589,218,2,0,216
بيروت الثانية,المصيطبة ,المصيطبة - مدرسة مار الياس بطينا  - غرفة رقم 10,روم ارثوذكس,594,100,1,2,99
بيروت الثانية,المصيطبة ,المصيطبة - مدرسة مار الياس بطينا  - غرفة رقم 11,روم ارثوذكس,581,175,7,5,168
بيروت الثانية,المصيطبة ,المصيطبة - مدرسة مار الياس بطينا  - غرفة رقم 12,روم كاثوليك,577,138,1,4,137
بيروت الثانية,المصيطبة ,المصيطبة - مدرسة مار الياس بطينا  - غرفة رقم 2,روم ارثوذكس,545,236,3,2,233
بيروت الثانية,المصيطبة ,المصيطبة - مدرسة مار الياس بطينا  - غرفة رقم 3,روم ارثوذكس,582,197,4,6,193
بيروت الثانية,المصيطبة ,المصيطبة - مدرسة مار الياس بطينا  - غرفة رقم 4,روم ارثوذكس,557,135,4,0,131
بيروت الثانية,المصيطبة ,المصيطبة - مدرسة مار الياس بطينا  - غرفة رقم 5,روم ارثوذكس,585,120,3,1,117
بيروت الثانية,المصيطبة ,المصيطبة - مدرسة مار الياس بطينا  - غرفة رقم 6,روم ارثوذكس,564,195,5,2,190
بيروت الثانية,المصيطبة ,المصيطبة - مدرسة مار الياس بطينا  - غرفة رقم 7,روم ارثوذكس,567,181,4,0,177
بيروت الثانية,المصيطبة ,المصيطبة - مدرسة مار الياس بطينا  - غرفة رقم 8,روم ارثوذكس,587,197,2,1,195
بيروت الثانية,المصيطبة ,المصيطبة - مدرسة مار الياس بطينا  - غرفة رقم 9,روم ارثوذكس,565,162,2,0,160
بيروت الثانية,المصيطبة ,المصيطبة - مدرسة وطى المصيطبة الرسمية المختلطة  - غرفة رقم 1,سريان كاثوليك,615,89,1,0,88
بيروت الثانية,المصيطبة ,المصيطبة - مدرسة وطى المصيطبة الرسمية المختلطة  - غرفة رقم 10,سريان كاثوليك,604,72,1,0,71
بيروت الثانية,المصيطبة ,المصيطبة - مدرسة وطى المصيطبة الرسمية المختلطة  - غرفة رقم 11,مختلف,569,144,15,0,129
بيروت الثانية,المصيطبة ,المصيطبة - مدرسة وطى المصيطبة الرسمية المختلطة  - غرفة رقم 12,مختلف,624,122,1,1,121
بيروت الثانية,المصيطبة ,المصيطبة - مدرسة وطى المصيطبة الرسمية المختلطة  - غرفة رقم 2,مختلف,569,67,3,1,64
بيروت الثانية,المصيطبة ,المصيطبة - مدرسة وطى المصيطبة الرسمية المختلطة  - غرفة رقم 3,سريان كاثوليك,604,87,0,0,87
بيروت الثانية,المصيطبة ,المصيطبة - مدرسة وطى المصيطبة الرسمية المختلطة  - غرفة رقم 4,مختلف,564,62,2,0,60
بيروت الثانية,المصيطبة ,المصيطبة - مدرسة وطى المصيطبة الرسمية المختلطة  - غرفة رقم 5,سريان كاثوليك,597,64,1,0,63
بيروت الثانية,المصيطبة ,المصيطبة - مدرسة وطى المصيطبة الرسمية المختلطة  - غرفة رقم 6,سريان كاثوليك,595,64,1,0,63
بيروت الثانية,المصيطبة ,المصيطبة - مدرسة وطى المصيطبة الرسمية المختلطة  - غرفة رقم 7,سريان كاثوليك,605,75,1,0,74
بيروت الثانية,المصيطبة ,المصيطبة - مدرسة وطى المصيطبة الرسمية المختلطة  - غرفة رقم 8,سريان كاثوليك,608,66,2,0,64
بيروت الثانية,المصيطبة ,المصيطبة - مدرسة وطى المصيطبة الرسمية المختلطة  - غرفة رقم 9,سريان كاثوليك,608,71,0,0,71
بيروت الثانية,بيروت الثانية موظفون ,بيروت الثانية موظفون - مرأب بلدية بيروت - بلوك ب - غرفة رقم 1,مختلف,375,329,4,4,325
بيروت الثانية,بيروت الثانية موظفون ,بيروت الثانية موظفون - مرأب بلدية بيروت - بلوك ب - غرفة رقم 2,مختلف,369,318,4,7,314
بيروت الثانية,دار المريسة ,دار المريسة - مدرسة الجمعية المسيحية للشابات- شارع رستم باشا  - غرفة رقم 1,سني,613,256,3,0,253
بيروت الثانية,دار المريسة ,دار المريسة - مدرسة الجمعية المسيحية للشابات- شارع رستم باشا  - غرفة رقم 10,سني,598,239,22,1,217
بيروت الثانية,دار المريسة ,دار المريسة - مدرسة الجمعية المسيحية للشابات- شارع رستم باشا  - غرفة رقم 11,سني,603,242,5,2,237
بيروت الثانية,دار المريسة ,دار المريسة - مدرسة الجمعية المسيحية للشابات- شارع رستم باشا  - غرفة رقم 12,درزي,471,216,18,0,198
بيروت الثانية,دار المريسة ,دار المريسة - مدرسة الجمعية المسيحية للشابات- شارع رستم باشا  - غرفة رقم 13,درزي,474,185,2,8,183
بيروت الثانية,دار المريسة ,دار المريسة - مدرسة الجمعية المسيحية للشابات- شارع رستم باشا  - غرفة رقم 14,درزي,495,215,15,1,200
بيروت الثانية,دار المريسة ,دار المريسة - مدرسة الجمعية المسيحية للشابات- شارع رستم باشا  - غرفة رقم 15,ماروني,539,128,2,1,126
بيروت الثانية,دار المريسة ,دار المريسة - مدرسة الجمعية المسيحية للشابات- شارع رستم باشا  - غرفة رقم 2,سني,625,305,12,2,293
بيروت الثانية,دار المريسة ,دار المريسة - مدرسة الجمعية المسيحية للشابات- شارع رستم باشا  - غرفة رقم 3,سني,641,271,0,2,271
بيروت الثانية,دار المريسة ,دار المريسة - مدرسة الجمعية المسيحية للشابات- شارع رستم باشا  - غرفة رقم 4,سني,613,251,14,1,237
بيروت الثانية,دار المريسة ,دار المريسة - مدرسة الجمعية المسيحية للشابات- شارع رستم باشا  - غرفة رقم 5,سني,645,278,8,1,270
بيروت الثانية,دار المريسة ,دار المريسة - مدرسة الجمعية المسيحية للشابات- شارع رستم باشا  - غرفة رقم 6,سني,601,277,16,3,261
بيروت الثانية,دار المريسة ,دار المريسة - مدرسة الجمعية المسيحية للشابات- شارع رستم باشا  - غرفة رقم 7,سني,575,218,7,2,211
بيروت الثانية,دار المريسة ,دار المريسة - مدرسة الجمعية المسيحية للشابات- شارع رستم باشا  - غرفة رقم 8,سني,625,315,3,1,312
بيروت الثانية,دار المريسة ,دار المريسة - مدرسة الجمعية المسيحية للشابات- شارع رستم باشا  - غرفة رقم 9,سني,606,251,11,3,240
بيروت الثانية,دار المريسة ,دار المريسة - مدرسة الحكمة - القنطاري  - غرفة رقم 1,شيعي,608,289,0,0,289
بيروت الثانية,دار المريسة ,دار المريسة - مدرسة الحكمة - القنطاري  - غرفة رقم 2,شيعي,609,289,3,0,286
بيروت الثانية,دار المريسة ,دار المريسة - مدرسة الحكمة - القنطاري  - غرفة رقم 3,شيعي,562,211,3,0,208
بيروت الثانية,دار المريسة ,دار المريسة - مدرسة الحكمة - القنطاري  - غرفة رقم 4,مسيحي,515,56,3,1,53
بيروت الثانية,دار المريسة ,دار المريسة - مدرسة الحكمة - القنطاري  - غرفة رقم 5,مسيحي,519,60,1,1,59
بيروت الثانية,دار المريسة ,دار المريسة - مدرسة الحكمة - القنطاري  - غرفة رقم 6,مسيحي,535,52,0,2,52
بيروت الثانية,دول إقليمية,دول إقليمية,مختلف,6621,3571,61,20,3510
بيروت الثانية,رأس بيروت ,رأس بيروت - تكميلية رأس بيروت الاولى المختلطة - طلعة الحمام العسكري  - غرفة رقم 1,سني,628,318,30,2,288
بيروت الثانية,رأس بيروت ,رأس بيروت - تكميلية رأس بيروت الاولى المختلطة - طلعة الحمام العسكري  - غرفة رقم 2,سني,660,322,7,2,315
بيروت الثانية,رأس بيروت ,رأس بيروت - تكميلية رأس بيروت الاولى المختلطة - طلعة الحمام العسكري  - غرفة رقم 3,سني,637,312,8,4,304
بيروت الثانية,رأس بيروت ,رأس بيروت - تكميلية رأس بيروت الاولى المختلطة - طلعة الحمام العسكري  - غرفة رقم 4,سني,665,348,11,4,337
بيروت الثانية,رأس بيروت ,رأس بيروت - تكميلية رأس بيروت الاولى المختلطة - طلعة الحمام العسكري  - غرفة رقم 5,سني,655,266,5,2,261
بيروت الثانية,رأس بيروت ,رأس بيروت - تكميلية رأس بيروت الاولى المختلطة - طلعة الحمام العسكري  - غرفة رقم 6,سني,634,209,4,0,205
بيروت الثانية,رأس بيروت ,رأس بيروت - تكميلية رأس بيروت الاولى المختلطة - طلعة الحمام العسكري  - غرفة رقم 7,سني,643,217,5,3,212
بيروت الثانية,رأس بيروت ,رأس بيروت - تكميلية رأس بيروت الاولى المختلطة - طلعة الحمام العسكري  - غرفة رقم 8,سني,654,294,6,2,288
بيروت الثانية,رأس بيروت ,رأس بيروت - ثانوية بيروت الحرج الرسمية المختلطة-منطقة الحمراء- شارع الصيداني  - غرفة رقم 1,روم ارثوذكس,552,55,1,0,54
بيروت الثانية,رأس بيروت ,رأس بيروت - ثانوية بيروت الحرج الرسمية المختلطة-منطقة الحمراء- شارع الصيداني  - غرفة رقم 10,إنجيلي,541,62,2,0,60
بيروت الثانية,رأس بيروت ,رأس بيروت - ثانوية بيروت الحرج الرسمية المختلطة-منطقة الحمراء- شارع الصيداني  - غرفة رقم 11,مختلف,559,91,1,0,90
بيروت الثانية,رأس بيروت ,رأس بيروت - ثانوية بيروت الحرج الرسمية المختلطة-منطقة الحمراء- شارع الصيداني  - غرفة رقم 12,مختلف,492,67,3,0,64
بيروت الثانية,رأس بيروت ,رأس بيروت - ثانوية بيروت الحرج الرسمية المختلطة-منطقة الحمراء- شارع الصيداني  - غرفة رقم 2,مختلف,421,74,3,1,71
بيروت الثانية,رأس بيروت ,رأس بيروت - ثانوية بيروت الحرج الرسمية المختلطة-منطقة الحمراء- شارع الصيداني  - غرفة رقم 3,روم ارثوذكس,453,41,1,1,40
بيروت الثانية,رأس بيروت ,رأس بيروت - ثانوية بيروت الحرج الرسمية المختلطة-منطقة الحمراء- شارع الصيداني  - غرفة رقم 4,شيعي,451,203,0,1,203
بيروت الثانية,رأس بيروت ,رأس بيروت - ثانوية بيروت الحرج الرسمية المختلطة-منطقة الحمراء- شارع الصيداني  - غرفة رقم 5,شيعي,434,181,3,0,178
بيروت الثانية,رأس بيروت ,رأس بيروت - ثانوية بيروت الحرج الرسمية المختلطة-منطقة الحمراء- شارع الصيداني  - غرفة رقم 6,درزي,507,225,7,0,218
بيروت الثانية,رأس بيروت ,رأس بيروت - ثانوية بيروت الحرج الرسمية المختلطة-منطقة الحمراء- شارع الصيداني  - غرفة رقم 7,درزي,589,231,9,2,222
بيروت الثانية,رأس بيروت ,رأس بيروت - ثانوية بيروت الحرج الرسمية المختلطة-منطقة الحمراء- شارع الصيداني  - غرفة رقم 8,مختلف,450,82,0,2,82
بيروت الثانية,رأس بيروت ,رأس بيروت - ثانوية بيروت الحرج الرسمية المختلطة-منطقة الحمراء- شارع الصيداني  - غرفة رقم 9,إنجيلي,491,58,2,0,56
بيروت الثانية,رأس بيروت ,رأس بيروت - ثانوية فردان مقابل سيار الدرك  - غرفة رقم 1,سني,620,203,7,3,196
بيروت الثانية,رأس بيروت ,رأس بيروت - ثانوية فردان مقابل سيار الدرك  - غرفة رقم 10,سني,659,340,3,4,337
بيروت الثانية,رأس بيروت ,رأس بيروت - ثانوية فردان مقابل سيار الدرك  - غرفة رقم 11,سني,671,350,8,3,342
بيروت الثانية,رأس بيروت ,رأس بيروت - ثانوية فردان مقابل سيار الدرك  - غرفة رقم 12,سني,655,346,5,4,341
بيروت الثانية,رأس بيروت ,رأس بيروت - ثانوية فردان مقابل سيار الدرك  - غرفة رقم 13,سني,632,321,5,1,316
بيروت الثانية,رأس بيروت ,رأس بيروت - ثانوية فردان مقابل سيار الدرك  - غرفة رقم 14,روم كاثوليك,536,59,1,0,58
بيروت الثانية,رأس بيروت ,رأس بيروت - ثانوية فردان مقابل سيار الدرك  - غرفة رقم 15,روم كاثوليك,455,54,1,0,53
بيروت الثانية,رأس بيروت ,رأس بيروت - ثانوية فردان مقابل سيار الدرك  - غرفة رقم 2,سني,641,280,7,4,273
بيروت الثانية,رأس بيروت ,رأس بيروت - ثانوية فردان مقابل سيار الدرك  - غرفة رقم 3,سني,646,301,4,5,297
بيروت الثانية,رأس بيروت ,رأس بيروت - ثانوية فردان مقابل سيار الدرك  - غرفة رقم 4,سني,646,351,14,1,337
بيروت الثانية,رأس بيروت ,رأس بيروت - ثانوية فردان مقابل سيار الدرك  - غرفة رقم 5,سني,625,316,17,1,299
بيروت الثانية,رأس بيروت ,رأس بيروت - ثانوية فردان مقابل سيار الدرك  - غرفة رقم 6,سني,644,303,16,0,287
بيروت الثانية,رأس بيروت ,رأس بيروت - ثانوية فردان مقابل سيار الدرك  - غرفة رقم 7,سني,634,289,13,4,276
بيروت الثانية,رأس بيروت ,رأس بيروت - ثانوية فردان مقابل سيار الدرك  - غرفة رقم 8,سني,641,290,0,4,290
بيروت الثانية,رأس بيروت ,رأس بيروت - ثانوية فردان مقابل سيار الدرك  - غرفة رقم 9,سني,637,336,9,0,327
بيروت الثانية,رأس بيروت ,رأس بيروت - مدرسة الامير شكيب ارسلان المتوسطة المختلطة  - غرفة رقم 1,سني,632,297,9,3,288
بيروت الثانية,رأس بيروت ,رأس بيروت - مدرسة الامير شكيب ارسلان المتوسطة المختلطة  - غرفة رقم 10,سني,657,358,9,10,349
بيروت الثانية,رأس بيروت ,رأس بيروت - مدرسة الامير شكيب ارسلان المتوسطة المختلطة  - غرفة رقم 11,سني,647,306,3,32,303
بيروت الثانية,رأس بيروت ,رأس بيروت - مدرسة الامير شكيب ارسلان المتوسطة المختلطة  - غرفة رقم 12,سني,400,315,2,1,313
بيروت الثانية,رأس بيروت ,رأس بيروت - مدرسة الامير شكيب ارسلان المتوسطة المختلطة  - غرفة رقم 13,سني,636,327,3,1,324
بيروت الثانية,رأس بيروت ,رأس بيروت - مدرسة الامير شكيب ارسلان المتوسطة المختلطة  - غرفة رقم 14,سني,637,342,7,1,335
بيروت الثانية,رأس بيروت ,رأس بيروت - مدرسة الامير شكيب ارسلان المتوسطة المختلطة  - غرفة رقم 15,سني,643,287,1,2,286
بيروت الثانية,رأس بيروت ,رأس بيروت - مدرسة الامير شكيب ارسلان المتوسطة المختلطة  - غرفة رقم 16,سني,632,237,7,4,230
بيروت الثانية,رأس بيروت ,رأس بيروت - مدرسة الامير شكيب ارسلان المتوسطة المختلطة  - غرفة رقم 2,سني,619,332,10,0,322
بيروت الثانية,رأس بيروت ,رأس بيروت - مدرسة الامير شكيب ارسلان المتوسطة المختلطة  - غرفة رقم 3,سني,593,309,9,4,300
بيروت الثانية,رأس بيروت ,رأس بيروت - مدرسة الامير شكيب ارسلان المتوسطة المختلطة  - غرفة رقم 4,سني,628,315,17,3,298
بيروت الثانية,رأس بيروت ,رأس بيروت - مدرسة الامير شكيب ارسلان المتوسطة المختلطة  - غرفة رقم 5,سني,618,314,6,3,308
بيروت الثانية,رأس بيروت ,رأس بيروت - مدرسة الامير شكيب ارسلان المتوسطة المختلطة  - غرفة رقم 6,سني,636,297,1,4,296
بيروت الثانية,رأس بيروت ,رأس بيروت - مدرسة الامير شكيب ارسلان المتوسطة المختلطة  - غرفة رقم 7,سني,657,342,3,2,339
بيروت الثانية,رأس بيروت ,رأس بيروت - مدرسة الامير شكيب ارسلان المتوسطة المختلطة  - غرفة رقم 8,سني,653,346,3,2,343
بيروت الثانية,رأس بيروت ,رأس بيروت - مدرسة الامير شكيب ارسلان المتوسطة المختلطة  - غرفة رقم 9,سني,654,335,14,1,321
بيروت الثانية,رأس بيروت ,رأس بيروت - مدرسة امين بيهم النموذجية المختلطة الرسمية - المنارة - شارع  زاهية قدورة  - غرفة رقم 1,ماروني,485,83,0,0,83
بيروت الثانية,رأس بيروت ,رأس بيروت - مدرسة امين بيهم النموذجية المختلطة الرسمية - المنارة - شارع  زاهية قدورة  - غرفة رقم 2,ماروني,518,71,3,0,68
بيروت الثانية,رأس بيروت ,رأس بيروت - مدرسة امين بيهم النموذجية المختلطة الرسمية - المنارة - شارع  زاهية قدورة  - غرفة رقم 3,روم ارثوذكس,523,125,0,3,125
بيروت الثانية,رأس بيروت ,رأس بيروت - مدرسة امين بيهم النموذجية المختلطة الرسمية - المنارة - شارع  زاهية قدورة  - غرفة رقم 4,روم ارثوذكس,545,68,0,1,68
بيروت الثانية,رأس بيروت ,رأس بيروت - مدرسة امين بيهم النموذجية المختلطة الرسمية - المنارة - شارع  زاهية قدورة  - غرفة رقم 5,روم ارثوذكس,552,64,0,0,64
بيروت الثانية,رأس بيروت ,رأس بيروت - مدرسة امين بيهم النموذجية المختلطة الرسمية - المنارة - شارع  زاهية قدورة  - غرفة رقم 6,روم ارثوذكس,422,74,1,1,73
بيروت الثانية,رأس بيروت ,رأس بيروت - مدرسة امين بيهم النموذجية المختلطة الرسمية - المنارة - شارع  زاهية قدورة  - غرفة رقم 7,روم ارثوذكس,517,141,5,3,136
بيروت الثانية,رأس بيروت ,رأس بيروت - مدرسة امين بيهم النموذجية المختلطة الرسمية - المنارة - شارع  زاهية قدورة  - غرفة رقم 8,روم ارثوذكس,542,65,0,0,65
بيروت الثانية,رأس بيروت ,رأس بيروت - مدرسة امين بيهم النموذجية المختلطة الرسمية - المنارة - شارع  زاهية قدورة  - غرفة رقم 9,روم ارثوذكس,528,64,1,0,63
بيروت الثانية,زقاق البلاط ,زقاق البلاط - المدرسة المعنية  - غرفة رقم 1,مختلف,559,135,7,0,128
بيروت الثانية,زقاق البلاط ,زقاق البلاط - المدرسة المعنية  - غرفة رقم 2,مسيحي,590,113,15,0,98
بيروت الثانية,زقاق البلاط ,زقاق البلاط - المدرسة المعنية  - غرفة رقم 3,مسيحي,556,107,0,2,107
بيروت الثانية,زقاق البلاط ,زقاق البلاط - المدرسة المعنية  - غرفة رقم 4,مسيحي,553,31,0,0,31
بيروت الثانية,زقاق البلاط ,زقاق البلاط - المدرسة المعنية  - غرفة رقم 5,أرمن ارثوذكس,489,45,2,0,43
بيروت الثانية,زقاق البلاط ,زقاق البلاط - المدرسة المعنية  - غرفة رقم 6,أرمن ارثوذكس,539,54,0,4,54
بيروت الثانية,زقاق البلاط ,زقاق البلاط - المدرسة المعنية  - غرفة رقم 7,أرمن ارثوذكس,526,44,1,0,43
بيروت الثانية,زقاق البلاط ,زقاق البلاط - المدرسة المعنية  - غرفة رقم 8,مختلف,499,79,5,1,74
بيروت الثانية,زقاق البلاط ,زقاق البلاط - ثانوية الحريري الثانية البطريركية - شارع عبد القادر  - غرفة رقم 1,سني,639,270,4,0,266
بيروت الثانية,زقاق البلاط ,زقاق البلاط - ثانوية الحريري الثانية البطريركية - شارع عبد القادر  - غرفة رقم 10,سني,630,133,0,1,133
بيروت الثانية,زقاق البلاط ,زقاق البلاط - ثانوية الحريري الثانية البطريركية - شارع عبد القادر  - غرفة رقم 11,سني,668,131,2,0,129
بيروت الثانية,زقاق البلاط ,زقاق البلاط - ثانوية الحريري الثانية البطريركية - شارع عبد القادر  - غرفة رقم 12,سني,665,183,7,1,176
بيروت الثانية,زقاق البلاط ,زقاق البلاط - ثانوية الحريري الثانية البطريركية - شارع عبد القادر  - غرفة رقم 2,سني,625,265,2,3,263
بيروت الثانية,زقاق البلاط ,زقاق البلاط - ثانوية الحريري الثانية البطريركية - شارع عبد القادر  - غرفة رقم 3,سني,617,302,9,0,293
بيروت الثانية,زقاق البلاط ,زقاق البلاط - ثانوية الحريري الثانية البطريركية - شارع عبد القادر  - غرفة رقم 4,سني,625,306,2,1,304
بيروت الثانية,زقاق البلاط ,زقاق البلاط - ثانوية الحريري الثانية البطريركية - شارع عبد القادر  - غرفة رقم 5,سني,633,254,2,3,252
بيروت الثانية,زقاق البلاط ,زقاق البلاط - ثانوية الحريري الثانية البطريركية - شارع عبد القادر  - غرفة رقم 6,سني,624,289,7,3,282
بيروت الثانية,زقاق البلاط ,زقاق البلاط - ثانوية الحريري الثانية البطريركية - شارع عبد القادر  - غرفة رقم 7,سني,577,273,11,3,262
بيروت الثانية,زقاق البلاط ,زقاق البلاط - ثانوية الحريري الثانية البطريركية - شارع عبد القادر  - غرفة رقم 8,سني,629,240,5,2,235
بيروت الثانية,زقاق البلاط ,زقاق البلاط - ثانوية الحريري الثانية البطريركية - شارع عبد القادر  - غرفة رقم 9,سني,627,141,15,0,126
بيروت الثانية,زقاق البلاط ,زقاق البلاط - سيتي انترناسيونال سكول - شارع حسين بيهم قرب الجامع  - غرفة رقم 1,سني,615,282,2,1,280
بيروت الثانية,زقاق البلاط ,زقاق البلاط - سيتي انترناسيونال سكول - شارع حسين بيهم قرب الجامع  - غرفة رقم 10,سني,625,136,5,0,131
بيروت الثانية,زقاق البلاط ,زقاق البلاط - سيتي انترناسيونال سكول - شارع حسين بيهم قرب الجامع  - غرفة رقم 11,سني,635,137,2,2,135
بيروت الثانية,زقاق البلاط ,زقاق البلاط - سيتي انترناسيونال سكول - شارع حسين بيهم قرب الجامع  - غرفة رقم 12,سني,637,206,34,2,172
بيروت الثانية,زقاق البلاط ,زقاق البلاط - سيتي انترناسيونال سكول - شارع حسين بيهم قرب الجامع  - غرفة رقم 13,سني,633,267,8,3,259
بيروت الثانية,زقاق البلاط ,زقاق البلاط - سيتي انترناسيونال سكول - شارع حسين بيهم قرب الجامع  - غرفة رقم 14,سني,612,258,12,1,246
بيروت الثانية,زقاق البلاط ,زقاق البلاط - سيتي انترناسيونال سكول - شارع حسين بيهم قرب الجامع  - غرفة رقم 15,سني,657,186,13,0,173
بيروت الثانية,زقاق البلاط ,زقاق البلاط - سيتي انترناسيونال سكول - شارع حسين بيهم قرب الجامع  - غرفة رقم 16,سني,634,212,10,0,202
بيروت الثانية,زقاق البلاط ,زقاق البلاط - سيتي انترناسيونال سكول - شارع حسين بيهم قرب الجامع  - غرفة رقم 2,سني,627,233,15,3,218
بيروت الثانية,زقاق البلاط ,زقاق البلاط - سيتي انترناسيونال سكول - شارع حسين بيهم قرب الجامع  - غرفة رقم 3,سني,622,173,15,0,158
بيروت الثانية,زقاق البلاط ,زقاق البلاط - سيتي انترناسيونال سكول - شارع حسين بيهم قرب الجامع  - غرفة رقم 4,سني,634,111,2,0,109
بيروت الثانية,زقاق البلاط ,زقاق البلاط - سيتي انترناسيونال سكول - شارع حسين بيهم قرب الجامع  - غرفة رقم 5,سني,645,133,7,6,126
بيروت الثانية,زقاق البلاط ,زقاق البلاط - سيتي انترناسيونال سكول - شارع حسين بيهم قرب الجامع  - غرفة رقم 6,سني,629,159,0,1,159
بيروت الثانية,زقاق البلاط ,زقاق البلاط - سيتي انترناسيونال سكول - شارع حسين بيهم قرب الجامع  - غرفة رقم 7,سني,661,151,3,0,148
بيروت الثانية,زقاق البلاط ,زقاق البلاط - سيتي انترناسيونال سكول - شارع حسين بيهم قرب الجامع  - غرفة رقم 8,سني,637,152,11,3,141
بيروت الثانية,زقاق البلاط ,زقاق البلاط - سيتي انترناسيونال سكول - شارع حسين بيهم قرب الجامع  - غرفة رقم 9,سني,647,132,2,1,130
بيروت الثانية,زقاق البلاط ,زقاق البلاط - متوسطة البنات الثانية - شارع سليم سلام  - غرفة رقم 1,شيعي,633,251,4,1,247
بيروت الثانية,زقاق البلاط ,زقاق البلاط - متوسطة البنات الثانية - شارع سليم سلام  - غرفة رقم 10,شيعي,610,303,17,3,286
بيروت الثانية,زقاق البلاط ,زقاق البلاط - متوسطة البنات الثانية - شارع سليم سلام  - غرفة رقم 11,شيعي,644,271,10,2,261
بيروت الثانية,زقاق البلاط ,زقاق البلاط - متوسطة البنات الثانية - شارع سليم سلام  - غرفة رقم 2,شيعي,661,290,6,4,284
بيروت الثانية,زقاق البلاط ,زقاق البلاط - متوسطة البنات الثانية - شارع سليم سلام  - غرفة رقم 3,شيعي,646,293,5,0,288
بيروت الثانية,زقاق البلاط ,زقاق البلاط - متوسطة البنات الثانية - شارع سليم سلام  - غرفة رقم 4,شيعي,641,293,0,1,293
بيروت الثانية,زقاق البلاط ,زقاق البلاط - متوسطة البنات الثانية - شارع سليم سلام  - غرفة رقم 5,شيعي,633,313,0,0,313
بيروت الثانية,زقاق البلاط ,زقاق البلاط - متوسطة البنات الثانية - شارع سليم سلام  - غرفة رقم 6,شيعي,614,315,3,4,312
بيروت الثانية,زقاق البلاط ,زقاق البلاط - متوسطة البنات الثانية - شارع سليم سلام  - غرفة رقم 7,شيعي,607,292,6,2,286
بيروت الثانية,زقاق البلاط ,زقاق البلاط - متوسطة البنات الثانية - شارع سليم سلام  - غرفة رقم 8,شيعي,628,308,1,3,307
بيروت الثانية,زقاق البلاط ,زقاق البلاط - متوسطة البنات الثانية - شارع سليم سلام  - غرفة رقم 9,شيعي,629,328,12,1,316
بيروت الثانية,زقاق البلاط ,زقاق البلاط - مدرسة الامداد - شارع يوسف الاسير  - غرفة رقم 1,شيعي,645,280,6,0,274
بيروت الثانية,زقاق البلاط ,زقاق البلاط - مدرسة الامداد - شارع يوسف الاسير  - غرفة رقم 2,شيعي,636,321,12,2,309
بيروت الثانية,زقاق البلاط ,زقاق البلاط - مدرسة الامداد - شارع يوسف الاسير  - غرفة رقم 3,شيعي,649,344,5,0,339
بيروت الثانية,زقاق البلاط ,زقاق البلاط - مدرسة الامداد - شارع يوسف الاسير  - غرفة رقم 4,شيعي,643,335,1,0,334
بيروت الثانية,زقاق البلاط ,زقاق البلاط - مدرسة الامداد - شارع يوسف الاسير  - غرفة رقم 5,شيعي,639,315,1,0,314
بيروت الثانية,زقاق البلاط ,زقاق البلاط - مدرسة الامداد - شارع يوسف الاسير  - غرفة رقم 6,شيعي,670,331,5,0,326
بيروت الثانية,زقاق البلاط ,زقاق البلاط - مدرسة الامداد - شارع يوسف الاسير  - غرفة رقم 7,شيعي,635,316,3,2,313
بيروت الثانية,زقاق البلاط ,زقاق البلاط - مدرسة الامداد - شارع يوسف الاسير  - غرفة رقم 8,شيعي,614,265,1,12,264
بيروت الثانية,زقاق البلاط ,زقاق البلاط - مدرسة البطريركية – شارع البطريركية  - غرفة رقم 1,سني,649,122,6,0,116
بيروت الثانية,زقاق البلاط ,زقاق البلاط - مدرسة البطريركية – شارع البطريركية  - غرفة رقم 10,سني,615,248,16,3,232
بيروت الثانية,زقاق البلاط ,زقاق البلاط - مدرسة البطريركية – شارع البطريركية  - غرفة رقم 11,سني,586,259,15,2,244
بيروت الثانية,زقاق البلاط ,زقاق البلاط - مدرسة البطريركية – شارع البطريركية  - غرفة رقم 12,سني,584,252,6,1,246
بيروت الثانية,زقاق البلاط ,زقاق البلاط - مدرسة البطريركية – شارع البطريركية  - غرفة رقم 13,سني,606,310,17,0,293
بيروت الثانية,زقاق البلاط ,زقاق البلاط - مدرسة البطريركية – شارع البطريركية  - غرفة رقم 14,سني,602,239,7,3,232
بيروت الثانية,زقاق البلاط ,زقاق البلاط - مدرسة البطريركية – شارع البطريركية  - غرفة رقم 15,سني,606,228,9,2,219
بيروت الثانية,زقاق البلاط ,زقاق البلاط - مدرسة البطريركية – شارع البطريركية  - غرفة رقم 16,سني,605,280,10,0,270
بيروت الثانية,زقاق البلاط ,زقاق البلاط - مدرسة البطريركية – شارع البطريركية  - غرفة رقم 2,سني,663,138,7,3,131
بيروت الثانية,زقاق البلاط ,زقاق البلاط - مدرسة البطريركية – شارع البطريركية  - غرفة رقم 3,سني,644,137,3,1,134
بيروت الثانية,زقاق البلاط ,زقاق البلاط - مدرسة البطريركية – شارع البطريركية  - غرفة رقم 4,سني,658,141,2,4,139
بيروت الثانية,زقاق البلاط ,زقاق البلاط - مدرسة البطريركية – شارع البطريركية  - غرفة رقم 5,سني,640,231,15,4,216
بيروت الثانية,زقاق البلاط ,زقاق البلاط - مدرسة البطريركية – شارع البطريركية  - غرفة رقم 6,سني,635,278,21,4,257
بيروت الثانية,زقاق البلاط ,زقاق البلاط - مدرسة البطريركية – شارع البطريركية  - غرفة رقم 7,سني,636,244,2,0,242
بيروت الثانية,زقاق البلاط ,زقاق البلاط - مدرسة البطريركية – شارع البطريركية  - غرفة رقم 8,سني,649,173,8,0,165
بيروت الثانية,زقاق البلاط ,زقاق البلاط - مدرسة البطريركية – شارع البطريركية  - غرفة رقم 9,سني,623,176,17,11,159
بيروت الثانية,زقاق البلاط ,زقاق البلاط - مدرسة زقاق البلاط الرسمية المختلطة قرب المخفر  - غرفة رقم 1,شيعي,664,294,4,1,290
بيروت الثانية,زقاق البلاط ,زقاق البلاط - مدرسة زقاق البلاط الرسمية المختلطة قرب المخفر  - غرفة رقم 2,شيعي,641,278,10,1,268
بيروت الثانية,زقاق البلاط ,زقاق البلاط - مدرسة زقاق البلاط الرسمية المختلطة قرب المخفر  - غرفة رقم 3,شيعي,621,244,2,1,242
بيروت الثانية,زقاق البلاط ,زقاق البلاط - مدرسة زقاق البلاط الرسمية المختلطة قرب المخفر  - غرفة رقم 4,شيعي,609,320,2,2,318
بيروت الثانية,زقاق البلاط ,زقاق البلاط - مدرسة زقاق البلاط الرسمية المختلطة قرب المخفر  - غرفة رقم 5,شيعي,602,320,8,2,312
بيروت الثانية,زقاق البلاط ,زقاق البلاط - مدرسة زقاق البلاط الرسمية المختلطة قرب المخفر  - غرفة رقم 6,شيعي,627,292,2,1,290
بيروت الثانية,زقاق البلاط ,زقاق البلاط - مدرسة زقاق البلاط الرسمية المختلطة قرب المخفر  - غرفة رقم 7,شيعي,646,293,2,0,291
بيروت الثانية,زقاق البلاط ,زقاق البلاط - مدرسة زقاق البلاط الرسمية المختلطة قرب المخفر  - غرفة رقم 8,شيعي,670,288,0,2,288
بيروت الثانية,زقاق البلاط ,زقاق البلاط - مدرسة زقاق البلاط الرسمية المختلطة قرب المخفر  - غرفة رقم 9,شيعي,656,310,6,0,304
بيروت الثانية,زقاق البلاط ,زقاق البلاط - مدرسة مار يوسف الضهور الابتدائية  - غرفة رقم 1,شيعي,663,288,12,2,276
بيروت الثانية,زقاق البلاط ,زقاق البلاط - مدرسة مار يوسف الضهور الابتدائية  - غرفة رقم 2,شيعي,622,291,6,1,285
بيروت الثانية,زقاق البلاط ,زقاق البلاط - مدرسة مار يوسف الضهور الابتدائية  - غرفة رقم 3,شيعي,607,254,0,0,254
بيروت الثانية,زقاق البلاط ,زقاق البلاط - مدرسة مار يوسف الضهور الابتدائية  - غرفة رقم 4,شيعي,639,287,4,3,283
بيروت الثانية,زقاق البلاط ,زقاق البلاط - مدرسة مار يوسف الضهور الابتدائية  - غرفة رقم 5,شيعي,649,324,8,3,316
بيروت الثانية,زقاق البلاط ,زقاق البلاط - مدرسة مار يوسف الضهور الابتدائية  - غرفة رقم 6,شيعي,627,298,12,2,286
بيروت الثانية,زقاق البلاط ,زقاق البلاط - مدرسة مار يوسف الضهور الابتدائية  - غرفة رقم 7,شيعي,619,295,7,2,288
بيروت الثانية,ميناء الحصن ,ميناء الحصن - المدرسة الارمنية الانجيلية العالية شارع المكسيك  - غرفة رقم 1,اسرائيلي,966,1,0,0,1
بيروت الثانية,ميناء الحصن ,ميناء الحصن - المدرسة الارمنية الانجيلية العالية شارع المكسيك  - غرفة رقم 10,مختلف,519,47,0,1,47
بيروت الثانية,ميناء الحصن ,ميناء الحصن - المدرسة الارمنية الانجيلية العالية شارع المكسيك  - غرفة رقم 2,اسرائيلي,979,0,0,0,0
بيروت الثانية,ميناء الحصن ,ميناء الحصن - المدرسة الارمنية الانجيلية العالية شارع المكسيك  - غرفة رقم 3,اسرائيلي,1035,4,0,0,4
بيروت الثانية,ميناء الحصن ,ميناء الحصن - المدرسة الارمنية الانجيلية العالية شارع المكسيك  - غرفة رقم 4,روم ارثوذكس,536,111,0,0,111
بيروت الثانية,ميناء الحصن ,ميناء الحصن - المدرسة الارمنية الانجيلية العالية شارع المكسيك  - غرفة رقم 5,روم ارثوذكس,560,96,2,2,94
بيروت الثانية,ميناء الحصن ,ميناء الحصن - المدرسة الارمنية الانجيلية العالية شارع المكسيك  - غرفة رقم 6,مختلف,548,65,0,0,65
بيروت الثانية,ميناء الحصن ,ميناء الحصن - المدرسة الارمنية الانجيلية العالية شارع المكسيك  - غرفة رقم 7,مسيحي,569,96,0,0,96
بيروت الثانية,ميناء الحصن ,ميناء الحصن - المدرسة الارمنية الانجيلية العالية شارع المكسيك  - غرفة رقم 8,شيعي,615,267,3,4,264
بيروت الثانية,ميناء الحصن ,ميناء الحصن - المدرسة الارمنية الانجيلية العالية شارع المكسيك  - غرفة رقم 9,مختلف,611,219,5,0,214
بيروت الثانية,ميناء الحصن ,ميناء الحصن - مدرسة ابي بكر الصديق القنطاري - شارع ميشال شيحا  - غرفة رقم 1,سني,600,290,5,3,285
بيروت الثانية,ميناء الحصن ,ميناء الحصن - مدرسة ابي بكر الصديق القنطاري - شارع ميشال شيحا  - غرفة رقم 2,سني,573,231,6,2,225
بيروت الثانية,ميناء الحصن ,ميناء الحصن - مدرسة ابي بكر الصديق القنطاري - شارع ميشال شيحا  - غرفة رقم 3,سني,602,278,3,0,275
بيروت الثانية,ميناء الحصن ,ميناء الحصن - مدرسة ابي بكر الصديق القنطاري - شارع ميشال شيحا  - غرفة رقم 4,سني,585,217,10,4,207
بيروت الثانية,ميناء الحصن ,ميناء الحصن - مدرسة ابي بكر الصديق القنطاري - شارع ميشال شيحا  - غرفة رقم 5,مختلف,603,199,0,3,199
بيروت الثانية,ميناء الحصن ,ميناء الحصن - مدرسة ابي بكر الصديق القنطاري - شارع ميشال شيحا  - غرفة رقم 6,مسيحي,561,97,0,1,97
بيروت الثانية,ميناء الحصن ,ميناء الحصن - مدرسة ابي بكر الصديق القنطاري - شارع ميشال شيحا  - غرفة رقم 7,اسرائيلي,1004,0,0,0,0
بيروت الثانية,ميناء الحصن ,ميناء الحصن - مدرسة الحكمة - القنطاري  - غرفة رقم 7,ماروني,562,128,0,3,128
بيروت الثانية,ميناء الحصن ,ميناء الحصن - مدرسة الحكمة - القنطاري  - غرفة رقم 8,ماروني,556,134,3,2,131
بيروت الثانية,ميناء الحصن ,ميناء الحصن - مدرسة الحكمة - القنطاري  - غرفة رقم 9,مختلف,556,135,0,1,135
جب جنين,البقاع الغربي موظفون ,سراي جب جنين - غرفة رقم 1,مختلف,361,327,8,14,319
جب جنين,البقاع الغربي موظفون ,سراي راشيا - غرفة رقم 1,مختلف,200,184,2,8,182
جب جنين,الخياره ,مدرسة الخيارة الرسمية - غرفة رقم 1,سني,571,265,7,0,258
جب جنين,الخياره ,مدرسة الخيارة الرسمية - غرفة رقم 2,سني,521,304,13,4,291
جب جنين,الدكوه ,المدرسة سابقا قرب كنيسة مار جرجس - غرفة رقم 1,مختلف,357,188,23,0,165
جب جنين,الدكوه ,المدرسة سابقا قرب كنيسة مار جرجس - غرفة رقم 2,مختلف,320,174,12,2,162
جب جنين,الروضة ,المدرسة الرسمية الاولى - غرفة رقم 1,سني,630,401,12,4,389
جب جنين,الروضة ,المدرسة الرسمية الاولى - غرفة رقم 2,سني,597,390,7,2,383
جب جنين,الروضة ,المدرسة الرسمية الاولى - غرفة رقم 3,سني,691,448,32,0,416
جب جنين,السلطان يعقوب التحتا ,المدرسة الرسمية - غرفة رقم 1,سني,540,164,5,1,159
جب جنين,السلطان يعقوب التحتا ,المدرسة الرسمية - غرفة رقم 2,سني,543,242,4,2,238
جب جنين,السلطان يعقوب التحتا ,المدرسة الرسمية - غرفة رقم 3,سني,557,319,3,1,316
جب جنين,السلطان يعقوب الفوقا ,المدرسة الرسمية - غرفة رقم 1,سني,561,161,3,3,158
جب جنين,السلطان يعقوب الفوقا ,المدرسة الرسمية - غرفة رقم 2,سني,571,233,2,0,231
جب جنين,السلطان يعقوب الفوقا ,المدرسة الرسمية - غرفة رقم 3,سني,582,249,6,1,243
جب جنين,الشبرقية ,قاعة كنيسة الوحدة والسلام في عميق - غرفة رقم 3,مختلف,36,12,1,0,11
جب جنين,الصويري ,المدرسة الرسمية - غرفة رقم 1,سني,628,287,4,2,283
جب جنين,الصويري ,المدرسة الرسمية - غرفة رقم 2,سني,621,258,27,1,231
جب جنين,الصويري ,المدرسة الرسمية - غرفة رقم 3,سني,664,292,9,5,283
جب جنين,الصويري ,المدرسة الرسمية - غرفة رقم 4,سني,585,438,11,1,427
جب جنين,الصويري ,مدرسة المقاصد الاسلامية - غرفة رقم 1,سني,649,457,12,0,445
جب جنين,الصويري ,مدرسة المقاصد الاسلامية - غرفة رقم 2,سني,626,416,16,1,400
جب جنين,الصويري ,مدرسة المقاصد الاسلامية - غرفة رقم 3,شيعي,438,260,5,1,255
جب جنين,القرعون ,التكميلية الرسمية - غرفة رقم 1,سني,571,207,4,3,203
جب جنين,القرعون ,التكميلية الرسمية - غرفة رقم 2,سني,603,225,6,2,219
جب جنين,القرعون ,التكميلية الرسمية - غرفة رقم 3,سني,603,214,3,0,211
جب جنين,القرعون ,التكميلية الرسمية - غرفة رقم 4,سني,578,212,1,1,211
جب جنين,القرعون ,التكميلية الرسمية - غرفة رقم 5,سني,568,179,6,1,173
جب جنين,القرعون ,التكميلية الرسمية - غرفة رقم 6,مسيحي,455,101,0,0,101
جب جنين,القرعون ,التكميلية الرسمية - غرفة رقم 7,مسيحي,456,116,1,0,115
جب جنين,القرعون ,الثانوية الرسمية - غرفة رقم 1,سني,554,248,4,0,244
جب جنين,القرعون ,الثانوية الرسمية - غرفة رقم 2,سني,551,257,8,1,249
جب جنين,القرعون ,الثانوية الرسمية - غرفة رقم 3,سني,568,226,1,2,225
جب جنين,القرعون ,الثانوية الرسمية - غرفة رقم 4,سني,560,221,1,1,220
جب جنين,القرعون ,الثانوية الرسمية - غرفة رقم 5,سني,552,195,4,3,191
جب جنين,المرج ,الثانوية الرسمية - غرفة رقم 1,سني,583,353,17,2,336
جب جنين,المرج ,الثانوية الرسمية - غرفة رقم 2,سني,567,356,15,2,341
جب جنين,المرج ,الثانوية الرسمية - غرفة رقم 3,سني,574,320,3,0,317
جب جنين,المرج ,الثانوية الرسمية - غرفة رقم 4,سني,615,351,11,2,340
جب جنين,المرج ,الثانوية الرسمية - غرفة رقم 5,سني,587,398,17,1,381
جب جنين,المرج ,الثانوية الرسمية - غرفة رقم 6,مختلف,208,66,0,0,66
جب جنين,المرج ,المدرسة الرسمية - غرفة رقم 1,سني,618,367,22,5,345
جب جنين,المرج ,المدرسة الرسمية - غرفة رقم 2,سني,615,337,9,3,328
جب جنين,المرج ,المدرسة الرسمية - غرفة رقم 3,سني,597,302,12,2,290
جب جنين,المرج ,المدرسة الرسمية - غرفة رقم 4,سني,615,392,13,3,379
جب جنين,المرج ,المدرسة الرسمية - غرفة رقم 5,سني,340,218,3,1,215
جب جنين,المرج ,حي المرج مدرسة الجراحية الرسمية - غرفة رقم 1,سني,306,208,35,0,173
جب جنين,المرج ,حي المرج مدرسة الجراحية الرسمية - غرفة رقم 2,سني,319,225,13,0,212
جب جنين,المنارة ,ثانوية المنارة الرسمية - غرفة رقم 1,سني,618,356,11,12,345
جب جنين,المنارة ,ثانوية المنارة الرسمية - غرفة رقم 2,سني,599,305,10,6,295
جب جنين,المنارة ,ثانوية المنارة الرسمية - غرفة رقم 3,سني,599,471,18,13,453
جب جنين,المنارة ,ثانوية المنارة الرسمية - غرفة رقم 4,سني,631,460,13,8,447
جب جنين,المنصوره ,المدرسة الرسمية الاولى - غرفة رقم 1,مسيحي,558,233,8,1,225
جب جنين,المنصوره ,المدرسة الرسمية الاولى - غرفة رقم 2,مسيحي,539,302,5,2,297
جب جنين,المنصوره ,المدرسة الرسمية الاولى - غرفة رقم 3,سني,625,442,10,2,432
جب جنين,باب مارع ,دار البلدية - غرفة رقم 1,مسيحي,549,204,11,5,193
جب جنين,بعلول ,المدرسة الرسمية - غرفة رقم 1,سني,637,119,0,0,119
جب جنين,بعلول ,المدرسة الرسمية - غرفة رقم 2,سني,621,96,4,0,92
جب جنين,بعلول ,المدرسة الرسمية - غرفة رقم 3,سني,628,182,3,1,179
جب جنين,بعلول ,المدرسة الرسمية - غرفة رقم 4,سني,624,141,0,0,141
جب جنين,تل ذنوب ,المدرسة الرسمية في البلدة القديمة - غرفة رقم 1,مختلف,314,161,1,0,160
جب جنين,تل ذنوب ,قاعة كنيسة مار مارون - غرفة رقم 1,مختلف,289,149,2,1,147
جب جنين,جب جنين ,التكميلية الرسمية للصبيان - غرفة رقم 1,سني,601,261,5,0,256
جب جنين,جب جنين ,التكميلية الرسمية للصبيان - غرفة رقم 2,سني,609,235,10,1,225
جب جنين,جب جنين ,التكميلية الرسمية للصبيان - غرفة رقم 3,سني,636,274,7,6,267
جب جنين,جب جنين ,التكميلية الرسمية للصبيان - غرفة رقم 4,سني,598,288,11,0,277
جب جنين,جب جنين ,التكميلية الرسمية للصبيان - غرفة رقم 5,سني,671,363,5,4,358
جب جنين,جب جنين ,التكميلية الرسمية للصبيان - غرفة رقم 6,سني,621,318,8,4,310
جب جنين,جب جنين ,التكميلية الرسمية للصبيان - غرفة رقم 7,سني,604,320,4,1,316
جب جنين,جب جنين ,التكميلية الرسمية للصبيان - غرفة رقم 8,سني,619,376,6,2,370
جب جنين,جب جنين ,ثانوية جب جنين الرسمية - غرفة رقم 1,مسيحي,458,155,2,1,153
جب جنين,جب جنين ,ثانوية جب جنين الرسمية - غرفة رقم 2,مسيحي,436,179,1,1,178
جب جنين,جب جنين ,ثانوية جب جنين الرسمية - غرفة رقم 3,روم كاثوليك,474,204,2,0,202
جب جنين,حوش الحريمه ,المدرسة الرسمية - غرفة رقم 1,سني,557,363,14,1,349
جب جنين,حوش الحريمه ,المدرسة الرسمية - غرفة رقم 2,سني,574,388,9,4,379
جب جنين,حوش الحريمه ,المدرسة الرسمية - غرفة رقم 3,سني,547,400,17,2,383
جب جنين,حوش الحريمه ,المدرسة الرسمية - غرفة رقم 4,سني,547,414,2,3,412
جب جنين,حوش الحريمه ,المدرسة الرسمية - غرفة رقم 5,سني,549,389,6,2,383
جب جنين,خربة قنافار ,المدرسة المهنية في خربة قنافار(مبنى البلدية قديما) - غرفة رقم 1,روم كاثوليك,565,226,6,0,220
جب جنين,خربة قنافار ,المدرسة المهنية في خربة قنافار(مبنى البلدية قديما) - غرفة رقم 2,ماروني,566,270,14,1,256
جب جنين,خربة قنافار ,المدرسة المهنية في خربة قنافار(مبنى البلدية قديما) - غرفة رقم 3,مختلف,563,287,1,3,286
جب جنين,خربة قنافار ,المدرسة المهنية في خربة قنافار(مبنى البلدية قديما) - غرفة رقم 4,ماروني,626,295,15,2,280
جب جنين,خربة قنافار ,المدرسة المهنية في خربة قنافار(مبنى البلدية قديما) - غرفة رقم 5,روم كاثوليك,581,237,9,0,228
جب جنين,خربة قنافار ,المدرسة المهنية في خربة قنافار(مبنى البلدية قديما) - غرفة رقم 6,مختلف,562,266,2,3,264
جب جنين,دول إقليمية,دول إقليمية,مختلف,3373,1805,175,6,1630
جب جنين,زلايا ,المدرسة الرسمية الاولى - غرفة رقم 1,شيعي,408,264,2,1,262
جب جنين,سحمر ,متوسطة سحمر الرسمية انكليزي - غرفة رقم 1,شيعي,590,388,5,2,383
جب جنين,سحمر ,متوسطة سحمر الرسمية انكليزي - غرفة رقم 2,شيعي,575,443,9,1,434
جب جنين,سحمر ,متوسطة سحمر الرسمية انكليزي - غرفة رقم 3,شيعي,603,474,3,0,471
جب جنين,سحمر ,متوسطة سحمر الرسمية انكليزي - غرفة رقم 4,شيعي,650,427,7,4,420
جب جنين,سحمر ,متوسطة سحمر الرسمية فرنسي - غرفة رقم 1,شيعي,629,364,1,2,363
جب جنين,سحمر ,متوسطة سحمر الرسمية فرنسي - غرفة رقم 2,شيعي,595,438,3,4,435
جب جنين,سحمر ,متوسطة سحمر الرسمية فرنسي - غرفة رقم 3,شيعي,622,440,8,6,432
جب جنين,صغبين ,ثانوية صغبين الرسمية - غرفة رقم 1,روم كاثوليك,588,215,5,1,210
جب جنين,صغبين ,ثانوية صغبين الرسمية - غرفة رقم 2,ماروني,620,242,8,3,234
جب جنين,صغبين ,ثانوية صغبين الرسمية - غرفة رقم 3,ماروني,529,147,5,1,142
جب جنين,صغبين ,ثانوية صغبين الرسمية - غرفة رقم 4,ماروني,573,221,4,1,217
جب جنين,صغبين ,ثانوية صغبين الرسمية - غرفة رقم 5,ماروني,537,154,3,1,151
جب جنين,صغبين ,ثانوية صغبين الرسمية - غرفة رقم 6,روم كاثوليك,585,210,8,3,202
جب جنين,صغبين ,ثانوية صغبين الرسمية - غرفة رقم 7,مسيحي,593,191,3,2,188
جب جنين,عانا ,المدرسة الرسمية - غرفة رقم 1,مسيحي,572,310,4,2,306
جب جنين,عانا ,المدرسة الرسمية - غرفة رقم 2,مسيحي,572,372,11,3,361
جب جنين,عميق ,قاعة كنيسة الوحدة والسلام - غرفة رقم 1,مختلف,513,235,10,1,225
جب جنين,عميق ,قاعة كنيسة الوحدة والسلام - غرفة رقم 2,مختلف,524,306,6,7,300
جب جنين,عيتنيت ,دار البلدية - غرفة رقم 1,روم كاثوليك,507,87,0,0,87
جب جنين,عيتنيت ,دار البلدية - غرفة رقم 2,روم كاثوليك,460,91,1,1,90
جب جنين,عيتنيت ,دار البلدية - غرفة رقم 3,مسيحي,447,61,2,1,59
جب جنين,عيتنيت ,دار البلدية - غرفة رقم 4,مسيحي,444,63,1,0,62
جب جنين,عين التينه ,المدرسة الرسمية الاولى - غرفة رقم 1,شيعي,497,185,0,0,185
جب جنين,عين التينه ,المدرسة الرسمية الاولى - غرفة رقم 2,شيعي,490,212,0,0,212
جب جنين,عين التينه ,المدرسة الرسمية الاولى - غرفة رقم 3,شيعي,452,218,2,0,216
جب جنين,عين زبده ,دار البلدية - غرفة رقم 1,ماروني,415,197,7,3,190
جب جنين,عين زبده ,دار البلدية - غرفة رقم 2,ماروني,392,194,4,0,190
جب جنين,عين زبده ,دار البلدية - غرفة رقم 3,ماروني,400,181,1,2,180
جب جنين,غزه ,التكميلية الرسمية - غرفة رقم 1,سني,628,284,16,1,268
جب جنين,غزه ,التكميلية الرسمية - غرفة رقم 2,سني,592,341,3,1,338
جب جنين,غزه ,التكميلية الرسمية - غرفة رقم 3,سني,648,346,8,0,338
جب جنين,غزه ,التكميلية الرسمية - غرفة رقم 4,سني,669,351,6,0,345
جب جنين,غزه ,ثانوية غزه الرسمية - غرفة رقم 1,سني,624,323,2,2,321
جب جنين,غزه ,ثانوية غزه الرسمية - غرفة رقم 2,سني,630,368,7,2,361
جب جنين,غزه ,ثانوية غزه الرسمية - غرفة رقم 3,سني,628,382,3,0,379
جب جنين,غزه ,ثانوية غزه الرسمية - غرفة رقم 4,سني,567,349,22,3,327
جب جنين,قليا ,المدرسة الرسمية الاولى - غرفة رقم 1,شيعي,483,251,1,0,250
جب جنين,قليا ,المدرسة الرسمية الاولى - غرفة رقم 2,شيعي,469,322,0,0,322
جب جنين,قليا ,المدرسة الرسمية الاولى - غرفة رقم 3,شيعي,469,301,4,0,297
جب جنين,كامد اللوز ,التكميلية الرسمية - غرفة رقم 1,سني,605,302,6,1,296
جب جنين,كامد اللوز ,التكميلية الرسمية - غرفة رقم 2,سني,600,276,1,3,275
جب جنين,كامد اللوز ,التكميلية الرسمية - غرفة رقم 3,سني,591,276,18,2,258
جب جنين,كامد اللوز ,التكميلية الرسمية - غرفة رقم 4,سني,548,260,3,3,257
جب جنين,كامد اللوز ,الثانوية الرسمية - غرفة رقم 1,سني,618,264,7,2,257
جب جنين,كامد اللوز ,الثانوية الرسمية - غرفة رقم 2,سني,627,251,7,2,244
جب جنين,كامد اللوز ,الثانوية الرسمية - غرفة رقم 3,سني,590,215,8,2,207
جب جنين,كامد اللوز ,الثانوية الرسمية - غرفة رقم 4,سني,593,214,7,5,207
جب جنين,كامد اللوز ,الثانوية الرسمية - غرفة رقم 5,سني,602,316,6,3,310
جب جنين,كفريا ,المدرسة الرسمية - غرفة رقم 1,مختلف,559,261,6,2,255
جب جنين,كفريا ,المدرسة الرسمية - غرفة رقم 2,مختلف,534,332,12,0,320
جب جنين,لالا ,المدرسة الرسمية - غرفة رقم 1,سني,603,151,4,3,147
جب جنين,لالا ,المدرسة الرسمية - غرفة رقم 2,سني,634,153,4,0,149
جب جنين,لالا ,المدرسة الرسمية - غرفة رقم 3,سني,600,155,2,3,153
جب جنين,لالا ,مدرسة المقاصد الاسلامية - غرفة رقم 1,سني,628,205,6,4,199
جب جنين,لالا ,مدرسة المقاصد الاسلامية - غرفة رقم 2,سني,622,231,0,2,231
جب جنين,لالا ,مدرسة المقاصد الاسلامية - غرفة رقم 3,سني,654,201,3,2,198
جب جنين,لالا ,مدرسة المقاصد الاسلامية - غرفة رقم 4,سني,602,157,1,3,156
جب جنين,لبايا ,المدرسة الرسمية - غرفة رقم 1,شيعي,580,329,10,4,319
جب جنين,لبايا ,المدرسة الرسمية - غرفة رقم 2,شيعي,570,307,3,3,304
جب جنين,لبايا ,المدرسة الرسمية - غرفة رقم 3,شيعي,537,273,6,2,267
جب جنين,لبايا ,المدرسة الرسمية - غرفة رقم 4,شيعي,552,362,24,2,338
جب جنين,لبايا ,المدرسة الرسمية - غرفة رقم 5,شيعي,543,338,6,2,332
جب جنين,لبايا ,المدرسة الرسمية - غرفة رقم 6,شيعي,574,352,5,0,347
جب جنين,لوسيا ,المدرسة الرسمية في ميدون - غرفة رقم 2,شيعي,219,190,1,0,189
جب جنين,مشغره التحتا ,المدرسة الرسمية للبنات - غرفة رقم 1,شيعي,596,275,11,2,264
جب جنين,مشغره التحتا ,المدرسة الرسمية للبنات - غرفة رقم 10,شيعي,617,335,0,3,335
جب جنين,مشغره التحتا ,المدرسة الرسمية للبنات - غرفة رقم 2,شيعي,629,345,3,3,342
جب جنين,مشغره التحتا ,المدرسة الرسمية للبنات - غرفة رقم 3,شيعي,615,289,8,1,281
جب جنين,مشغره التحتا ,المدرسة الرسمية للبنات - غرفة رقم 4,شيعي,617,309,8,3,301
جب جنين,مشغره التحتا ,المدرسة الرسمية للبنات - غرفة رقم 5,شيعي,634,355,10,0,345
جب جنين,مشغره التحتا ,المدرسة الرسمية للبنات - غرفة رقم 6,شيعي,620,290,11,1,279
جب جنين,مشغره التحتا ,المدرسة الرسمية للبنات - غرفة رقم 7,شيعي,612,334,7,3,327
جب جنين,مشغره التحتا ,المدرسة الرسمية للبنات - غرفة رقم 8,شيعي,621,274,11,1,263
جب جنين,مشغره التحتا ,المدرسة الرسمية للبنات - غرفة رقم 9,شيعي,608,302,6,3,296
جب جنين,مشغره التحتا ,المدرسة الرسمية للصبيان – حي التعمير - غرفة رقم 1,مختلف,586,155,1,0,154
جب جنين,مشغره التحتا ,المدرسة الرسمية للصبيان – حي التعمير - غرفة رقم 2,مختلف,552,154,1,1,153
جب جنين,مشغره الفوقا ,المدرسة الرسمية للصبيان – حي التعمير - غرفة رقم 1,روم كاثوليك,465,96,1,0,95
جب جنين,مشغره الفوقا ,المدرسة الرسمية للصبيان – حي التعمير - غرفة رقم 2,روم كاثوليك,460,134,0,1,134
جب جنين,مشغره الفوقا ,المدرسة الرسمية للصبيان – حي التعمير - غرفة رقم 3,روم كاثوليك,487,74,0,0,74
جب جنين,مشغره الفوقا ,المدرسة الرسمية للصبيان – حي التعمير - غرفة رقم 4,روم كاثوليك,476,89,6,0,83
جب جنين,مشغره الفوقا ,المدرسة الرسمية للصبيان – حي التعمير - غرفة رقم 5,روم كاثوليك,492,134,0,1,134
جب جنين,مشغره الفوقا ,المدرسة الرسمية للصبيان – حي التعمير - غرفة رقم 6,روم كاثوليك,484,73,0,2,73
جب جنين,مشغره الفوقا ,المدرسة الرسمية للصبيان – حي التعمير - غرفة رقم 7,مسيحي,592,187,1,1,186
جب جنين,مشغره الفوقا ,المدرسة الرسمية للصبيان – حي التعمير - غرفة رقم 8,مسيحي,632,198,2,1,196
جب جنين,ميدون ,المدرسة الرسمية - غرفة رقم 1,شيعي,488,403,4,0,399
جب جنين,يحمر ,متوسطة يحمر الرسمية الجديدة - غرفة رقم 1,شيعي,622,383,5,4,378
جب جنين,يحمر ,متوسطة يحمر الرسمية الجديدة - غرفة رقم 2,شيعي,583,404,3,3,401
جب جنين,يحمر ,متوسطة يحمر الرسمية الجديدة - غرفة رقم 3,شيعي,637,364,4,0,360
جبيل,اده ,صالون كنيسة مار جرجس - غرفة رقم 1,ماروني,459,272,2,2,270
جبيل,ادونيس ,صالة كنيسة مار انطونيوس - غرفة رقم 1,ماروني,490,331,5,0,326
جبيل,افقا ,الحسينية - غرفة رقم 1,شيعي,502,374,4,0,370
جبيل,افقا ,الحسينية - غرفة رقم 2,شيعي,529,410,4,0,406
جبيل,افقا ,الحسينية - غرفة رقم 3,شيعي,522,409,6,0,403
جبيل,البرباره ,دار البلدية - غرفة رقم 1,روم ارثوذكس,504,206,1,0,205
جبيل,الجليسه ,دير مار ضومط - غرفة رقم 1,ماروني,426,259,5,2,254
جبيل,الحصون ,المدرسة الرسمية في دير دون بوسكو - غرفة رقم 1,مختلف,334,206,16,2,190
جبيل,الحصون ,المدرسة الرسمية في دير دون بوسكو - غرفة رقم 2,مختلف,375,254,9,2,245
جبيل,الخاربه ,النادي الرياضي - غرفة رقم 1,ماروني,271,177,0,1,177
جبيل,الراموط ,ساحة الكنيسة - غرفة رقم 1,ماروني,113,59,0,0,59
جبيل,الريحانة ,صالون الكنيسة الريحانة - غرفة رقم 1,مسيحي,142,106,0,0,106
جبيل,الصوانه ,الحسينية - غرفة رقم 1,شيعي,630,437,37,5,400
جبيل,العاقورة ,مبنى دار البلدية - غرفة رقم 1,ماروني,542,350,0,3,350
جبيل,العاقورة ,مبنى دار البلدية - غرفة رقم 2,ماروني,597,386,8,2,378
جبيل,العاقورة ,مدرسة الراهبات - غرفة رقم 1,ماروني,478,318,4,1,314
جبيل,العاقورة ,مدرسة الراهبات - غرفة رقم 2,ماروني,456,271,1,2,270
جبيل,العاقورة ,مدرسة الراهبات - غرفة رقم 3,ماروني,455,264,5,0,259
جبيل,العاقورة ,مدرسة الراهبات - غرفة رقم 4,ماروني,528,325,6,2,319
جبيل,العاقورة ,مدرسة الراهبات - غرفة رقم 5,ماروني,491,312,3,1,309
جبيل,العاقورة ,مدرسة الراهبات - غرفة رقم 6,ماروني,492,268,4,1,264
جبيل,الغابات ,قاعة الكنيسة - غرفة رقم 1,ماروني,470,326,11,0,315
جبيل,الفيدار ,المدرسة الرسمية - غرفة رقم 1,ماروني,386,276,0,2,276
جبيل,الفيدار ,المدرسة الرسمية - غرفة رقم 2,ماروني,408,310,1,1,309
جبيل,الكفر ,صالون كنيسة سيدة النجاة - غرفة رقم 1,ماروني,388,259,4,1,255
جبيل,اللقلوق ,جامع البلدة - غرفة رقم 1,سني,550,260,16,7,244
جبيل,اللقلوق ,دار البلدية - غرفة رقم 1,سني,500,231,11,7,220
جبيل,المجدل ,صالون كنيسة مار سابا - غرفة رقم 1,ماروني,438,322,2,0,320
جبيل,المجدل ,صالون كنيسة مار سابا - غرفة رقم 2,ماروني,446,324,10,1,314
جبيل,المجدل ,صالون كنيسة مار سابا - غرفة رقم 3,مختلف,424,246,5,1,241
جبيل,المزاريب ,صالون الكنيسة - غرفة رقم 1,ماروني,518,343,9,3,334
جبيل,المغيره ,المدرسة الرسمية - غرفة رقم 1,مختلف,574,373,7,2,366
جبيل,المغيره ,المدرسة الرسمية - غرفة رقم 2,مختلف,634,407,2,2,405
جبيل,المنصف ,مدرسة المنصف الاهلية - غرفة رقم 1,روم ارثوذكس,372,175,5,1,170
جبيل,المنصف ,مدرسة المنصف الاهلية - غرفة رقم 2,روم ارثوذكس,446,194,3,1,191
جبيل,اهمج ,تكميلية اهمج الرسمية - غرفة رقم 1,ماروني,508,333,9,3,324
جبيل,اهمج ,تكميلية اهمج الرسمية - غرفة رقم 2,ماروني,499,367,1,0,366
جبيل,اهمج ,تكميلية اهمج الرسمية - غرفة رقم 3,ماروني,509,362,6,0,356
جبيل,اهمج ,ثانوية اهمج - غرفة رقم 1,ماروني,534,353,0,3,353
جبيل,اهمج ,ثانوية اهمج - غرفة رقم 2,ماروني,521,366,3,1,363
جبيل,بجه ,صالون الكنيسة - غرفة رقم 1,ماروني,523,329,0,2,329
جبيل,بجه ,صالون الكنيسة - غرفة رقم 2,ماروني,599,390,9,2,381
جبيل,بحديدات ,صالون الكنيسة الجديد - غرفة رقم 1,ماروني,211,157,1,0,156
جبيل,بخعاز ,النادي الرياضي - غرفة رقم 1,روم ارثوذكس,123,75,0,0,75
جبيل,بزيون ,مبنى الحسينية - غرفة رقم 1,شيعي,251,177,1,0,176
جبيل,بشتليدا ,بيت الوقف - غرفة رقم 1,شيعي,532,313,6,2,307
جبيل,بشتليدا ,بيت الوقف - غرفة رقم 2,شيعي,567,351,8,0,343
جبيل,بشللي ,المدرسة الرسمية - غرفة رقم 1,ماروني,390,303,1,1,302
جبيل,بلاط ,مدرسة الملاك الحارس - غرفة رقم 1,ماروني,525,413,1,0,412
جبيل,بلاط ,مدرسة الملاك الحارس - غرفة رقم 2,ماروني,533,430,18,2,412
جبيل,بلاط ,مدرسة الملاك الحارس - غرفة رقم 3,مسيحي,541,403,11,8,392
جبيل,بنتاعل ,قاعة كنيسة مار ماما - غرفة رقم 1,ماروني,344,183,0,0,183
جبيل,بيت حباق ,مدرسة الراهبات - غرفة رقم 1,ماروني,108,108,1,0,107
جبيل,ترتج ,المدرسة الرسمية - غرفة رقم 1,ماروني,545,386,8,5,378
جبيل,ترتج ,المدرسة الرسمية - غرفة رقم 2,ماروني,524,312,5,2,307
جبيل,ترتج ,المدرسة الرسمية - غرفة رقم 3,ماروني,535,392,7,9,385
جبيل,ترتج ,المدرسة الرسمية - غرفة رقم 4,ماروني,494,314,11,6,303
جبيل,جاج ,القصر البلدي - غرفة رقم 1,ماروني,537,338,2,1,336
جبيل,جاج ,القصر البلدي - غرفة رقم 2,ماروني,531,317,2,1,315
جبيل,جاج ,القصر البلدي - غرفة رقم 3,ماروني,550,370,6,0,364
جبيل,جاج ,القصر البلدي - غرفة رقم 4,ماروني,532,346,11,0,335
جبيل,جاج ,القصر البلدي - غرفة رقم 5,ماروني,510,245,0,0,245
جبيل,جبيل ,المدرسة الرسمية التكميلية الأولى - غرفة رقم 1,ماروني,565,401,5,1,396
جبيل,جبيل ,المدرسة الرسمية التكميلية الأولى - غرفة رقم 2,ماروني,547,356,2,0,354
جبيل,جبيل ,المدرسة الرسمية التكميلية الأولى - غرفة رقم 3,ماروني,523,354,6,4,348
جبيل,جبيل ,المدرسة الرسمية التكميلية الأولى - غرفة رقم 4,ماروني,519,347,8,0,339
جبيل,جبيل ,المدرسة الرسمية التكميلية الرابعة - غرفة رقم 1,مسيحي,572,332,2,2,330
جبيل,جبيل ,المدرسة الرسمية التكميلية الرابعة - غرفة رقم 2,ارمن  ,507,141,5,1,136
جبيل,جبيل ,المدرسة الرسمية التكميلية الرابعة - غرفة رقم 3,أرمن ارثوذكس,468,121,4,2,117
جبيل,جبيل ,المدرسة الرسمية التكميلية الرابعة - غرفة رقم 4,مختلف,543,245,4,1,241
جبيل,جبيل ,المدرسة الرسمية الثانية - غرفة رقم 1,ماروني,546,257,19,0,238
جبيل,جبيل ,المدرسة الرسمية الثانية - غرفة رقم 2,مسيحي,515,280,3,1,277
جبيل,جبيل ,المدرسة الرسمية الثانية - غرفة رقم 3,مسلم,549,371,17,3,354
جبيل,جبيل ,المدرسة الرسمية الثانية - غرفة رقم 4,سني,424,234,9,4,225
جبيل,جبيل ,المدرسة الرسمية الثانية - غرفة رقم 5,ماروني,529,377,11,1,366
جبيل,جبيل ,ثانوية جبيل - غرفة رقم 1,ماروني,526,383,5,1,378
جبيل,جبيل ,ثانوية جبيل - غرفة رقم 2,ماروني,534,377,5,0,372
جبيل,جبيل ,ثانوية جبيل - غرفة رقم 3,ماروني,542,366,0,2,366
جبيل,جبيل ,ثانوية جبيل - غرفة رقم 4,ماروني,506,352,3,1,349
جبيل,جبيل موظفون ,سراي جبيل - غرفة رقم 1,مختلف,284,264,1,3,263
جبيل,جدايل ,نادي جدايل الرياضي - غرفة رقم 1,مسيحي,565,317,7,2,310
جبيل,جنه ومار سركيس ,دير مار سركيس - غرفة رقم 1,ماروني,320,239,2,2,237
جبيل,حاقل ,النادي الرياضي - غرفة رقم 1,ماروني,368,277,1,1,276
جبيل,حالات ,المدرسة الرسمية - غرفة رقم 1,ماروني,529,411,3,2,408
جبيل,حالات ,المدرسة الرسمية - غرفة رقم 2,ماروني,478,308,4,0,304
جبيل,حالات ,صالون كنيسة مار جرجس - غرفة رقم 1,ماروني,521,417,6,1,411
جبيل,حالات ,صالون كنيسة مار جرجس - غرفة رقم 2,ماروني,504,320,9,1,311
جبيل,حبالين ,ساحة كنيسة سيدة النجاة - غرفة رقم 1,ماروني,171,69,0,0,69
جبيل,حجولا ,حسينية البلدة - غرفة رقم 1,شيعي,483,294,2,0,292
جبيل,حجولا ,حسينية البلدة - غرفة رقم 2,شيعي,533,347,5,1,342
جبيل,حصارات ,المدرسة الرسمية - غرفة رقم 1,ماروني,517,264,1,1,263
جبيل,حصارات ,المدرسة الرسمية - غرفة رقم 2,ماروني,510,358,16,3,342
جبيل,حصرايل ,مركز البلدية - غرفة رقم 1,ماروني,436,283,6,3,277
جبيل,دملصا ,صالون الكنيسة - غرفة رقم 1,ماروني,231,200,2,1,198
جبيل,دول إقليمية,دول إقليمية,مختلف,1898,1322,10,6,1312
جبيل,دير القطاره ,ثانوية ميفوق الرسمية - غرفة رقم 4,ماروني,417,280,2,1,278
جبيل,راس اسطا ,حسينية البلدة - غرفة رقم 1,شيعي,464,331,3,2,328
جبيل,راس اسطا ,مركز البلدية - غرفة رقم 1,شيعي,499,369,9,0,360
جبيل,زبدين ,مركز زبدين الثقافي - غرفة رقم 1,ماروني,481,348,1,1,347
جبيل,ساقية الخيط ,بهو الكنيسة - غرفة رقم 1,ماروني,113,113,0,0,113
جبيل,سرعيتا ,صالون كنيسة مار الياس - غرفة رقم 1,ماروني,264,197,0,0,197
جبيل,سقي رشميا ,صالة الكنيسة - غرفة رقم 1,ماروني,306,203,0,1,203
جبيل,شامات ,رابطة اّل شديد - غرفة رقم 1,ماروني,457,315,2,0,313
جبيل,شموت ,المدرسة الرسمية - غرفة رقم 1,ماروني,217,137,5,0,132
جبيل,شيخان ,قاعة الكنيسة - غرفة رقم 1,روم ارثوذكس,219,115,2,1,113
جبيل,طورزيا ,دار رعية مار ضومط في شخنيا في طورزيا - غرفة رقم 1,مختلف,338,228,1,1,227
جبيل,عبيدات ,صالة الكنيسة - غرفة رقم 1,ماروني,399,188,1,1,187
جبيل,عبيدات ,صالة الكنيسة - غرفة رقم 2,ماروني,388,187,1,2,186
جبيل,علمات الجنوبية ,الحسينية - غرفة رقم 2,شيعي,454,295,8,0,287
جبيل,علمات الجنوبية ,الحسينية - غرفة رقم 3,شيعي,475,313,23,0,290
جبيل,علمات الجنوبية ,المستوصف - غرفة رقم 1,شيعي,465,315,18,1,297
جبيل,علمات الشمالية ,المدرسة الرسمية - غرفة رقم 1,شيعي,533,357,9,4,348
جبيل,علمات الشمالية ,المدرسة الرسمية - غرفة رقم 2,شيعي,515,378,14,2,364
جبيل,علمات الشمالية ,مدرسة علمات الشمالية - غرفة رقم 1,شيعي,524,333,1,1,332
جبيل,عمشيت ,ثانوية عمشيت الرسمية - غرفة رقم 1,ماروني,568,385,1,2,384
جبيل,عمشيت ,ثانوية عمشيت الرسمية - غرفة رقم 2,ماروني,567,364,3,4,361
جبيل,عمشيت ,ثانوية عمشيت الرسمية - غرفة رقم 3,ماروني,602,400,10,5,390
جبيل,عمشيت ,ثانوية عمشيت الرسمية - غرفة رقم 4,ماروني,526,385,4,0,381
جبيل,عمشيت ,ثانوية عمشيت الرسمية - غرفة رقم 5,ماروني,524,354,1,0,353
جبيل,عمشيت ,ثانوية عمشيت الرسمية - غرفة رقم 6,ماروني,512,338,3,4,335
جبيل,عمشيت ,ثانوية عمشيت الرسمية - غرفة رقم 7,مسيحي,547,383,8,1,375
جبيل,عنايا وكفربعال ,مركز البلدية - غرفة رقم 1,ماروني,296,230,2,0,228
جبيل,عين الدلبة ,حسينية البلدة - غرفة رقم 1,مختلف,203,105,4,2,101
جبيل,عين الشلال ,بيت جاهز قرب منزل المختار محسن ذيب العلاوي - غرفة رقم 1,سني,461,148,1,2,147
جبيل,عين الغويبة ,النادي الحسيني - غرفة رقم 1,شيعي,424,260,0,3,260
جبيل,عين الغويبة ,النادي الحسيني - غرفة رقم 2,شيعي,464,293,1,1,292
جبيل,عين جرين ,صالون كنيسة مار انطونيوس - غرفة رقم 1,مختلف,279,165,1,1,164
جبيل,عين كفاع ,صالة كنيسة مار روحانا - غرفة رقم 1,ماروني,256,165,3,2,162
جبيل,غرزوز ,صالون الكنيسة - غرفة رقم 1,روم ارثوذكس,315,137,1,0,136
جبيل,غرفين ,صالة كنيسة مار اسطفان - غرفة رقم 1,ماروني,149,70,1,1,69
جبيل,غلبون ,صالون كنيسة مار جرجس - غرفة رقم 1,ماروني,443,257,1,0,256
جبيل,غلبون ,صالون كنيسة مار جرجس - غرفة رقم 2,ماروني,425,269,1,0,268
جبيل,فتري ,مركز البلدية - غرفة رقم 1,ماروني,320,241,6,1,235
جبيل,فتري ,مركز البلدية - غرفة رقم 2,ماروني,337,252,6,1,246
جبيل,فدار ,قاعة كنيسة مار ماما - غرفة رقم 2,ماروني,469,369,1,0,368
جبيل,فرات ,بيت جاهز في ساحة الجامع - غرفة رقم 1,شيعي,213,113,9,1,104
جبيل,فرحت ,بيت جاهز قرب منزل المختار نجيب متى - غرفة رقم 1,مختلف,405,279,4,0,275
جبيل,فغال ,صالون رعية مار مخايل الكائن قرب كنيسة الرعية - غرفة رقم 1,ماروني,561,344,0,0,344
جبيل,قرطبا الجنوبية ,المدرسة الرسمية - غرفة رقم 1,ماروني,545,268,3,2,265
جبيل,قرطبا الجنوبية ,المدرسة الرسمية - غرفة رقم 2,ماروني,575,386,8,2,378
جبيل,قرطبا الجنوبية ,المدرسة الرسمية - غرفة رقم 3,ماروني,544,256,6,3,250
جبيل,قرطبا الجنوبية ,المدرسة الرسمية - غرفة رقم 4,ماروني,569,377,13,0,364
جبيل,قرطبا الجنوبية ,المدرسة الرسمية - غرفة رقم 5,ماروني,571,304,5,1,299
جبيل,قرطبا الشمالية ,السنترال - غرفة رقم 1,ماروني,496,296,13,0,283
جبيل,قرطبا الشمالية ,دار البلدية الجديد - غرفة رقم 1,ماروني,505,250,3,0,247
جبيل,قرطبا الشمالية ,دار البلدية الجديد - غرفة رقم 2,ماروني,543,346,2,3,344
جبيل,قرطبا الشمالية ,دير الراهبات الدون بوسكو - غرفة رقم 1,ماروني,467,120,0,0,120
جبيل,قرطبا الشمالية ,صالون كنيسة مار الياس - غرفة رقم 1,ماروني,507,243,2,0,241
جبيل,قرطبا الشمالية ,صالون كنيسة مار الياس - غرفة رقم 2,ماروني,519,334,11,1,323
جبيل,قرطبا الشمالية ,صالون كنيسة مار الياس - غرفة رقم 3,ماروني,516,272,1,1,271
جبيل,قرقريا ,قاعة الجامع - غرفة رقم 1,شيعي,360,263,7,0,256
جبيل,قهمز ,المدرسة الرسمية - غرفة رقم 1,ماروني,450,366,8,0,358
جبيل,قهمز ,المدرسة الرسمية - غرفة رقم 2,ماروني,421,319,5,2,314
جبيل,كفر كده ,صالون الكنيسة - غرفة رقم 1,ماروني,143,89,0,0,89
جبيل,كفر مسحون ,مدرسة كفرمسحون الرسمية - غرفة رقم 1,ماروني,235,158,0,0,158
جبيل,كفون ,دار الوقف - غرفة رقم 1,ماروني,558,457,1,1,456
جبيل,لاسا ,المدرسة الرسمية - غرفة رقم 1,شيعي,551,388,20,2,368
جبيل,لاسا ,المدرسة الرسمية - غرفة رقم 2,شيعي,564,416,19,3,397
جبيل,لاسا ,المدرسة الرسمية - غرفة رقم 3,شيعي,557,404,5,1,399
جبيل,لاسا ,المدرسة الرسمية - غرفة رقم 4,شيعي,554,375,16,3,359
جبيل,لاسا ,المدرسة الرسمية - غرفة رقم 5,شيعي,555,373,4,2,369
جبيل,لاسا ,المستوصف الخيري الملاصق للبلدية - غرفة رقم 1,مختلف,567,327,6,2,321
جبيل,لحفد ,المدرسة الرسمية - غرفة رقم 1,ماروني,556,326,5,1,321
جبيل,لحفد ,المدرسة الرسمية - غرفة رقم 2,ماروني,586,369,10,4,359
جبيل,مزرعة السياد ,مبنى البلدية - غرفة رقم 1,مختلف,512,372,9,3,363
جبيل,مزرعة السياد ,مبنى البلدية - غرفة رقم 2,مختلف,500,349,2,1,347
جبيل,مزرعة السياد ,مبنى البلدية - غرفة رقم 3,شيعي,534,265,11,0,254
جبيل,مشان ,مدرسة البلدة - غرفة رقم 1,مختلف,518,327,5,0,322
جبيل,مشان ,مدرسة البلدة - غرفة رقم 2,مختلف,550,379,13,2,366
جبيل,مشمش ,مدرسة مار يوسف - غرفة رقم 1,ماروني,465,337,6,5,331
جبيل,مشمش ,مدرسة مار يوسف - غرفة رقم 2,ماروني,475,364,7,1,357
جبيل,مشمش ,مدرسة مار يوسف - غرفة رقم 3,ماروني,460,293,2,2,291
جبيل,معاد ,النادي الرياضي في بلدة معاد - غرفة رقم 1,ماروني,354,226,0,2,226
جبيل,ميفوق ,ثانوية ميفوق الرسمية - غرفة رقم 1,ماروني,451,267,3,2,264
جبيل,ميفوق ,ثانوية ميفوق الرسمية - غرفة رقم 2,ماروني,450,280,1,2,279
جبيل,ميفوق ,ثانوية ميفوق الرسمية - غرفة رقم 3,ماروني,440,286,3,1,283
جبيل,نهر ابراهيم ,جامعة كنام (CNAM) الطابق الأرضي - غرفة رقم 1,ماروني,383,383,6,1,377
جبيل,نهر ابراهيم ,جامعة كنام (CNAM) الطابق الأول - غرفة رقم 2,ماروني,517,396,3,2,393
جبيل,هابيل ,كنيسة مار جرجس هابيل - غرفة رقم 1,ماروني,263,178,0,0,178
جبيل,يانوح ,بهو الكنيسة - غرفة رقم 1,مختلف,614,436,9,0,427
جبيل,يانوح ,بهو الكنيسة - غرفة رقم 2,مختلف,608,415,23,2,392
جزين,الجرمق ,صالون كنيسة مار مارون - غرفة رقم 1,مختلف,476,275,5,2,270
جزين,الجرمق ,صالون كنيسة مار مارون - غرفة رقم 2,مختلف,509,304,6,3,298
جزين,الحرف ,النادي الثقافي في الحرف - غرفة رقم 1,ماروني,293,182,1,2,181
جزين,الحسانيه ,المدرسة الرسمية - غرفة رقم 1,روم كاثوليك,391,243,4,1,239
جزين,الحمصية ,صالون الكنيسة - غرفة رقم 1,ماروني,267,110,4,0,106
جزين,الريحان ,المدرسة الرسمية الجديدة - غرفة رقم 1,شيعي,601,326,4,2,322
جزين,الريحان ,المدرسة الرسمية الجديدة - غرفة رقم 2,شيعي,577,328,3,1,325
جزين,الريحان ,المدرسة الرسمية الجديدة - غرفة رقم 3,شيعي,537,250,2,1,248
جزين,الريحان ,المدرسة الرسمية الجديدة - غرفة رقم 4,شيعي,601,364,3,0,361
جزين,الريحان ,المدرسة الرسمية الجديدة - غرفة رقم 5,شيعي,615,362,3,1,359
جزين,الريحان ,المدرسة الرسمية الجديدة - غرفة رقم 6,شيعي,611,265,1,2,264
جزين,السريره ,المدرسة الرسمية - غرفة رقم 1,روم كاثوليك,344,171,2,5,169
جزين,العيشية ,المدرسة الرسمية - غرفة رقم 1,روم كاثوليك,599,299,3,4,296
جزين,العيشية ,المدرسة الرسمية - غرفة رقم 2,ماروني,580,315,3,3,312
جزين,العيشية ,المدرسة الرسمية - غرفة رقم 3,ماروني,567,307,7,1,300
جزين,العيشية ,المدرسة الرسمية - غرفة رقم 4,ماروني,597,323,13,2,310
جزين,الغباطيه ,صالون الكنيسة - غرفة رقم 1,ماروني,366,199,0,1,199
جزين,القطراني ,مدرسة داريا والقطراني - غرفة رقم 1,ماروني,469,236,6,0,230
جزين,اللويزه ,المدرسة الرسمية - غرفة رقم 1,روم كاثوليك,566,394,2,3,392
جزين,اللويزه ,المدرسة الرسمية - غرفة رقم 2,ماروني,634,432,1,0,431
جزين,المحاربيه ,صالون الكنيسة - غرفة رقم 1,ماروني,219,114,1,1,113
جزين,المكنونيه ,صالون كنيسة البلدة - غرفة رقم 1,ماروني,319,187,3,0,184
جزين,المكنونيه ,صالون كنيسة البلدة - غرفة رقم 2,ماروني,338,189,3,0,186
جزين,الميدان ,المدرسة الرسمية - غرفة رقم 1,روم كاثوليك,541,206,3,1,203
جزين,الميدان ,المدرسة الرسمية - غرفة رقم 2,ماروني,553,203,2,2,201
جزين,انان ,صالون الكنيسة - غرفة رقم 1,ماروني,488,287,4,0,283
جزين,بتدين اللقش ,القصر البلدي الجديد - غرفة رقم 1,ماروني,318,167,2,1,165
جزين,بتدين اللقش ,القصر البلدي الجديد - غرفة رقم 2,ماروني,375,206,0,1,206
جزين,بحنين ,كفرتعلا دير المخلص بحنين - غرفة رقم 1,ماروني,286,166,7,1,159
جزين,بسري ,صالون الكنيسة - غرفة رقم 1,ماروني,344,167,4,2,163
جزين,بصليا ,بهو الكنيسة - غرفة رقم 1,ماروني,231,125,4,0,121
جزين,بكاسين ,المدرسة الرسمية - غرفة رقم 1,روم كاثوليك,481,223,2,1,221
جزين,بكاسين ,المدرسة الرسمية - غرفة رقم 2,ماروني,479,163,1,2,162
جزين,بكاسين ,المدرسة الرسمية - غرفة رقم 3,ماروني,463,116,0,0,116
جزين,بكاسين ,المدرسة الرسمية - غرفة رقم 4,ماروني,518,246,6,0,240
جزين,بكاسين ,المدرسة الرسمية - غرفة رقم 5,ماروني,507,211,0,1,211
جزين,بكاسين ,المدرسة الرسمية - غرفة رقم 6,ماروني,495,118,0,1,118
جزين,بنواتي ,المدرسة الرسمية - غرفة رقم 1,روم كاثوليك,382,217,9,3,208
جزين,بنواتي ,المدرسة الرسمية - غرفة رقم 2,ماروني,399,216,22,5,194
جزين,بيصور ,صالون الكنيسة - غرفة رقم 1,ماروني,538,316,5,4,311
جزين,تعيد ,المدرسة الرسمية - غرفة رقم 1,روم كاثوليك,139,88,2,0,86
جزين,جرنايا ,المدرسة الرسمية - غرفة رقم 1,روم كاثوليك,463,211,1,0,210
جزين,جرنايا ,المدرسة الرسمية - غرفة رقم 2,ماروني,463,227,3,1,224
جزين,جرنايا ,المدرسة الرسمية - غرفة رقم 3,ماروني,486,225,0,1,225
جزين,جزين ,المدرسة الرسمية التكميلية - غرفة رقم 1,ماروني,571,343,2,3,341
جزين,جزين ,المدرسة الرسمية التكميلية - غرفة رقم 2,ماروني,591,359,9,2,350
جزين,جزين ,المدرسة الرسمية التكميلية - غرفة رقم 3,ماروني,604,303,3,2,300
جزين,جزين ,المدرسة الرسمية التكميلية - غرفة رقم 4,ماروني,603,297,9,7,288
جزين,جزين ,المدرسة الرسمية التكميلية - غرفة رقم 5,ماروني,596,342,3,0,339
جزين,جزين ,المدرسة الرسمية التكميلية - غرفة رقم 6,ماروني,592,241,1,0,240
جزين,جزين ,المدرسة الرسمية التكميلية - غرفة رقم 7,مسيحي,609,218,0,0,218
جزين,جزين ,ثانوية جزين الرسمية - غرفة رقم 1,ماروني,527,343,5,0,338
جزين,جزين ,ثانوية جزين الرسمية - غرفة رقم 2,ماروني,572,345,6,1,339
جزين,جزين ,ثانوية جزين الرسمية - غرفة رقم 3,ماروني,550,329,4,2,325
جزين,جزين ,ثانوية جزين الرسمية - غرفة رقم 4,ماروني,544,269,2,1,267
جزين,جزين ,ثانوية جزين الرسمية - غرفة رقم 5,ماروني,550,294,4,1,290
جزين,جزين ,ثانوية جزين الرسمية - غرفة رقم 6,ماروني,569,350,0,2,350
جزين,جزين ,ثانوية جزين الرسمية - غرفة رقم 7,ماروني,548,229,0,2,229
جزين,جزين ,ثانوية جزين الرسمية - غرفة رقم 8,مسيحي,550,217,2,1,215
جزين,جزين موظفون ,سراي جزين - غرفة رقم 1,مختلف,249,226,1,2,225
جزين,جنسنايا ,صالون الكنيسة - غرفة رقم 1,ماروني,361,212,6,2,206
جزين,حيتولى ,بهو كنيسة وادي الليمون - غرفة رقم 1,مسيحي,511,308,7,0,301
جزين,حيطوره ,مبنى البلدية - غرفة رقم 1,ماروني,383,161,8,4,153
جزين,حيطوره ,مبنى البلدية - غرفة رقم 2,ماروني,460,201,2,3,199
جزين,دول إقليمية,دول إقليمية,مختلف,1719,1107,41,5,1066
جزين,روم ,المدرسة الرسمية - غرفة رقم 1,روم كاثوليك,433,225,3,1,222
جزين,روم ,المدرسة الرسمية - غرفة رقم 2,ماروني,500,285,6,4,279
جزين,روم ,المدرسة الرسمية - غرفة رقم 3,ماروني,519,310,9,2,301
جزين,روم ,المدرسة الرسمية - غرفة رقم 4,ماروني,534,336,7,2,329
جزين,ريمات وشقاديف ,صالون الكنيسة - غرفة رقم 1,ماروني,253,167,2,1,165
جزين,زحلته ,مبنى البلدية ( الجديد) - غرفة رقم 1,ماروني,523,278,6,7,272
جزين,سجد ,المدرسة الرسمية الجديدة - غرفة رقم 1,شيعي,492,302,3,5,299
جزين,سجد ,المدرسة الرسمية الجديدة - غرفة رقم 2,شيعي,530,342,2,2,340
جزين,سنيه ,صالون الكنيسة - غرفة رقم 1,ماروني,389,220,1,3,219
جزين,شواليق ,بهو الكنيسة - غرفة رقم 1,ماروني,609,373,1,1,372
جزين,صباح ,مبنى البلدية - غرفة رقم 1,ماروني,504,281,0,1,281
جزين,صفارية ,مستوصف البلدة - غرفة رقم 1,ماروني,543,260,2,2,258
جزين,صفارية ,مستوصف البلدة - غرفة رقم 2,ماروني,577,284,2,1,282
جزين,صيدون ,المدرسة الرسمية - غرفة رقم 1,روم كاثوليك,568,364,0,3,364
جزين,عاراي ,صالون الكنيسة - غرفة رقم 1,ماروني,454,298,5,1,293
جزين,عاراي ,صالون الكنيسة - غرفة رقم 2,ماروني,445,300,4,4,296
جزين,عازور ,مبنى البلدية - غرفة رقم 1,ماروني,437,165,0,0,165
جزين,عازور ,مبنى البلدية - غرفة رقم 2,ماروني,466,174,1,0,173
جزين,عرمتي ,المدرسة الرسمية - غرفة رقم 1,روم كاثوليك,578,336,3,2,333
جزين,عرمتي ,المدرسة الرسمية - غرفة رقم 2,ماروني,571,320,0,4,320
جزين,عرمتي ,المدرسة الرسمية - غرفة رقم 3,ماروني,560,348,1,1,347
جزين,عرمتي ,المدرسة الرسمية - غرفة رقم 4,ماروني,555,319,1,5,318
جزين,عرمتي ,المدرسة الرسمية - غرفة رقم 5,ماروني,552,321,2,2,319
جزين,عين المير ,المدرسة الرسمية - غرفة رقم 1,روم كاثوليك,523,316,50,5,266
جزين,عين مجدلين ,المدرسة الرسمية - غرفة رقم 1,روم كاثوليك,516,309,4,1,305
جزين,عين مجدلين ,المدرسة الرسمية - غرفة رقم 2,ماروني,486,329,4,7,325
جزين,قتالة ,صالون الكنيسة - غرفة رقم 1,ماروني,603,185,2,0,183
جزين,قطين وحيداب ,صالون الكنيسة - غرفة رقم 1,ماروني,392,203,0,1,203
جزين,قيتولي ,المدرسة الرسمية - غرفة رقم 1,روم كاثوليك,474,233,4,3,229
جزين,قيتولي ,المدرسة الرسمية - غرفة رقم 2,ماروني,435,97,2,1,95
جزين,قيتولي ,المدرسة الرسمية - غرفة رقم 3,ماروني,507,230,3,0,227
جزين,قيتولي ,المدرسة الرسمية - غرفة رقم 4,ماروني,461,112,1,1,111
جزين,قيتولي ,مركز البلدية القديم - غرفة رقم 1,روم كاثوليك,496,243,6,2,237
جزين,قيتولي ,مركز البلدية القديم - غرفة رقم 2,روم كاثوليك,220,220,3,0,217
جزين,كرخا ,مركز البلدية - غرفة رقم 1,روم كاثوليك,517,209,4,0,205
جزين,كفر جره ,المدرسة الرسمية - غرفة رقم 1,روم كاثوليك,379,177,2,0,175
جزين,كفرحونه ,المدرسة الرسمية - غرفة رقم 1,روم كاثوليك,547,234,2,1,232
جزين,كفرحونه ,المدرسة الرسمية - غرفة رقم 2,ماروني,506,210,6,1,204
جزين,كفرحونه ,المدرسة الرسمية - غرفة رقم 3,ماروني,515,184,2,2,182
جزين,كفرحونه ,المدرسة الرسمية - غرفة رقم 4,ماروني,546,184,1,2,183
جزين,كفرحونه ,المدرسة الرسمية - غرفة رقم 5,ماروني,563,256,5,0,251
جزين,كفرحونه ,المدرسة الرسمية - غرفة رقم 6,ماروني,569,235,3,0,232
جزين,كفرحونه ,المدرسة الرسمية - غرفة رقم 7,روم كاثوليك,576,193,3,2,190
جزين,كفرحونه ,المدرسة الرسمية - غرفة رقم 8,مسيحي,566,191,0,1,191
جزين,كفرفالوس ,صالون الكنيسة - غرفة رقم 1,ماروني,478,279,2,1,277
جزين,لبعه ,ثانوية لبعا الرسمية - غرفة رقم 1,ماروني,589,308,4,3,304
جزين,لبعه ,ثانوية لبعا الرسمية - غرفة رقم 2,ماروني,601,325,6,1,319
جزين,مجيدل ,المدرسة الرسمية - غرفة رقم 1,روم كاثوليك,351,166,1,2,165
جزين,مجيدل ,المدرسة الرسمية - غرفة رقم 2,ماروني,462,201,2,4,199
جزين,مراح الحباس ,صالون الكنيسة - غرفة رقم 1,ماروني,387,220,0,4,220
جزين,مزرعة المطحنة ,صالون الكنيسة - غرفة رقم 1,ماروني,327,179,3,6,176
جزين,مشموشه ,بيت الجمعية الخيرية - غرفة رقم 1,ماروني,454,177,9,3,168
جزين,مليخ ,المدرسة الرسمية الجديدة - غرفة رقم 1,شيعي,561,290,5,0,285
جزين,مليخ ,المدرسة الرسمية الجديدة - غرفة رقم 2,شيعي,535,299,9,1,290
جزين,مليخ ,المدرسة الرسمية الجديدة - غرفة رقم 3,شيعي,445,209,2,3,207
جزين,مليخ ,المدرسة الرسمية الجديدة - غرفة رقم 4,شيعي,436,238,3,2,235
جزين,وادي بعنقودين ,صالون الكنيسة - غرفة رقم 1,ماروني,483,298,2,0,296
جزين,وادي جزين ,مبنى البلدية - غرفة رقم 1,ماروني,458,217,1,1,216
جزين,وادي جزين ,مبنى البلدية - غرفة رقم 2,ماروني,454,227,2,1,225
حاصبيا,ابو قمحه ,نادي البلدة - غرفة رقم 1,مسيحي,216,40,0,0,40
حاصبيا,الخلوات ,المدرسة الرسمية - غرفة رقم 1,درزي,496,211,2,4,209
حاصبيا,الخلوات ,المدرسة الرسمية - غرفة رقم 2,درزي,443,286,0,5,286
حاصبيا,الخلوات ,المدرسة الرسمية - غرفة رقم 3,درزي,440,229,8,1,221
حاصبيا,الدلافة ,المدرسة الرسمية (مبنى البلدية) - غرفة رقم 1,شيعي,395,215,0,2,215
حاصبيا,الفرديس ,المدرسة الرسمية سابقا (مبنى البلديه) - غرفة رقم 1,مختلف,579,336,3,3,333
حاصبيا,الكفير ,المدرسة الرسمية (مبنى البلديه) - غرفة رقم 1,درزي,599,225,2,2,223
حاصبيا,الكفير ,المدرسة الرسمية (مبنى البلديه) - غرفة رقم 2,درزي,625,315,3,7,312
حاصبيا,الكفير ,المدرسة الرسمية (مبنى البلديه) - غرفة رقم 3,روم ارثوذكس,411,92,4,1,88
حاصبيا,الكفير ,المدرسة الرسمية (مبنى البلديه) - غرفة رقم 4,روم ارثوذكس,408,102,1,2,101
حاصبيا,الكفير ,المدرسة الرسمية (مبنى البلديه) - غرفة رقم 5,مسيحي,389,60,1,1,59
حاصبيا,الماري ,مدرسة الماري الرسمية - غرفة رقم 1,درزي,500,240,9,8,231
حاصبيا,الماري ,مدرسة الماري الرسمية - غرفة رقم 2,درزي,470,254,4,2,250
حاصبيا,المجيديه ,المدرسة الرسمية في المجيدية - غرفة رقم 3,سني,99,63,2,0,61
حاصبيا,الهبارية ,مبنى البلدية (المدرسة الرسمية سابقا) - غرفة رقم 1,سني,571,271,8,0,263
حاصبيا,الهبارية ,مبنى البلدية (المدرسة الرسمية سابقا) - غرفة رقم 2,سني,582,327,2,2,325
حاصبيا,الهبارية ,مبنى البلدية (المدرسة الرسمية سابقا) - غرفة رقم 3,سني,573,305,2,2,303
حاصبيا,الهبارية ,مبنى البلدية (المدرسة الرسمية سابقا) - غرفة رقم 4,سني,550,317,20,1,297
حاصبيا,الهبارية ,مبنى البلدية (المدرسة الرسمية سابقا) - غرفة رقم 5,سني,541,275,7,3,268
حاصبيا,برغز ,المركز الصحي في البلدة - غرفة رقم 1,درزي,196,117,2,2,115
حاصبيا,حاصبيا حي السراي ,المدرسة الرسمية للبنات - غرفة رقم 1,درزي,552,267,2,1,265
حاصبيا,حاصبيا حي السراي ,المدرسة الرسمية للبنات - غرفة رقم 2,درزي,589,324,5,7,319
حاصبيا,حاصبيا حي السراي ,المدرسة الرسمية للبنات - غرفة رقم 3,مختلف,477,107,1,0,106
حاصبيا,حاصبيا حي السراي ,المدرسة الرسمية للبنات - غرفة رقم 4,مختلف,566,133,0,0,133
حاصبيا,حاصبيا حي العين ,المدرسة الرسمية للبنات - غرفة رقم 5,مختلف,445,47,0,0,47
حاصبيا,حاصبيا حي العين ,المدرسة الرسمية للبنات - غرفة رقم 6,مختلف,466,159,6,1,153
حاصبيا,حاصبيا حي العين ,المدرسة الرسمية للبنات - غرفة رقم 7,مختلف,465,46,2,0,44
حاصبيا,حاصبيا حي العين ,المدرسة الرسمية للبنات - غرفة رقم 8,مختلف,495,177,1,3,176
حاصبيا,حاصبيا حي الفوقاني ,مبنى الداهورية مقابل بلدية حاصبيا - غرفة رقم 1,درزي,503,240,6,6,234
حاصبيا,حاصبيا حي الفوقاني ,مبنى الداهورية مقابل بلدية حاصبيا - غرفة رقم 2,درزي,489,245,4,3,241
حاصبيا,حاصبيا حي الفوقاني ,مبنى الداهورية مقابل بلدية حاصبيا - غرفة رقم 3,درزي,518,282,2,1,280
حاصبيا,حاصبيا حي الفوقاني ,مبنى الداهورية مقابل بلدية حاصبيا - غرفة رقم 4,درزي,513,280,1,5,279
حاصبيا,حاصبيا حي صفيفة ,المدرسة الرسمية للبنات - غرفة رقم 10,درزي,524,240,6,3,234
حاصبيا,حاصبيا حي صفيفة ,المدرسة الرسمية للبنات - غرفة رقم 11,مختلف,537,318,4,5,314
حاصبيا,حاصبيا حي صفيفة ,المدرسة الرسمية للبنات - غرفة رقم 12,درزي,520,283,2,4,281
حاصبيا,حاصبيا حي صفيفة ,المدرسة الرسمية للبنات - غرفة رقم 9,مختلف,526,263,3,9,260
حاصبيا,راشيا الفخار ,مبنى بلدية راشيا الفخار - غرفة رقم 1,روم ارثوذكس,479,157,2,5,155
حاصبيا,راشيا الفخار ,مبنى بلدية راشيا الفخار - غرفة رقم 2,مسيحي,463,84,0,0,84
حاصبيا,راشيا الفخار ,مبنى بلدية راشيا الفخار - غرفة رقم 3,روم ارثوذكس,454,155,7,3,148
حاصبيا,راشيا الفخار ,مبنى بلدية راشيا الفخار - غرفة رقم 4,مسيحي,452,89,0,2,89
حاصبيا,شبعا شرقي ,المدرسة الرسمية - غرفة رقم 1,سني,605,285,3,1,282
حاصبيا,شبعا شرقي ,المدرسة الرسمية - غرفة رقم 2,سني,586,281,1,0,280
حاصبيا,شبعا شرقي ,المدرسة الرسمية - غرفة رقم 3,سني,584,309,6,0,303
حاصبيا,شبعا شرقي ,المدرسة الرسمية - غرفة رقم 4,مختلف,564,221,5,1,216
حاصبيا,شبعا شرقي ,المدرسة الرسمية - غرفة رقم 5,سني,635,317,4,0,313
حاصبيا,شبعا شرقي ,المدرسة الرسمية - غرفة رقم 6,سني,610,285,2,1,283
حاصبيا,شبعا شرقي ,المدرسة الرسمية - غرفة رقم 7,سني,596,348,2,2,346
حاصبيا,شبعا شرقي ,المدرسة الرسمية - غرفة رقم 8,مختلف,631,250,5,0,245
حاصبيا,شبعا غربي ,الثانوية الرسمية في شبعا - غرفة رقم 1,سني,606,246,0,1,246
حاصبيا,شبعا غربي ,الثانوية الرسمية في شبعا - غرفة رقم 2,سني,609,275,13,1,262
حاصبيا,شبعا غربي ,الثانوية الرسمية في شبعا - غرفة رقم 3,سني,617,289,3,2,286
حاصبيا,شبعا غربي ,الثانوية الرسمية في شبعا - غرفة رقم 4,سني,591,279,2,4,277
حاصبيا,شبعا غربي ,الثانوية الرسمية في شبعا - غرفة رقم 5,سني,598,211,2,0,209
حاصبيا,شبعا غربي ,الثانوية الرسمية في شبعا - غرفة رقم 6,سني,597,245,1,1,244
حاصبيا,شبعا غربي ,المدرسة الرسمية - غرفة رقم 10,سني,641,252,1,1,251
حاصبيا,شبعا غربي ,المدرسة الرسمية - غرفة رقم 11,سني,653,285,6,2,279
حاصبيا,شبعا غربي ,المدرسة الرسمية - غرفة رقم 12,سني,643,312,4,1,308
حاصبيا,شبعا غربي ,المدرسة الرسمية - غرفة رقم 13,سني,661,312,0,4,312
حاصبيا,شبعا غربي ,المدرسة الرسمية - غرفة رقم 14,سني,667,261,3,2,258
حاصبيا,شبعا غربي ,المدرسة الرسمية - غرفة رقم 15,سني,644,273,1,3,272
حاصبيا,شبعا غربي ,المدرسة الرسمية - غرفة رقم 16,سني,578,257,1,1,256
حاصبيا,شبعا غربي ,المدرسة الرسمية - غرفة رقم 9,سني,646,288,4,1,284
حاصبيا,شويا ,تكميلية شويا الرسمية - غرفة رقم 1,درزي,578,311,6,5,305
حاصبيا,شويا ,تكميلية شويا الرسمية - غرفة رقم 2,درزي,590,361,4,2,357
حاصبيا,شويا ,تكميلية شويا الرسمية - غرفة رقم 3,مختلف,545,264,2,3,262
حاصبيا,عين جرفا ,المدرسة الرسمية - غرفة رقم 1,درزي,486,288,4,3,284
حاصبيا,عين جرفا ,المدرسة الرسمية - غرفة رقم 2,درزي,459,296,1,1,295
حاصبيا,عين قنيا ,المدرسة الرسمية - غرفة رقم 1,درزي,612,332,4,0,328
حاصبيا,عين قنيا ,المدرسة الرسمية - غرفة رقم 2,درزي,589,421,0,4,421
حاصبيا,عين قنيا ,المدرسة الرسمية - غرفة رقم 3,مختلف,603,313,3,4,310
حاصبيا,كفر حمام ,المدرسة الرسمية /البلدية - غرفة رقم 1,سني,514,195,2,0,193
حاصبيا,كفر حمام ,المدرسة الرسمية /البلدية - غرفة رقم 2,سني,519,240,2,0,238
حاصبيا,كفر حمام ,المدرسة الرسمية /البلدية - غرفة رقم 3,سني,508,216,3,0,213
حاصبيا,كفرشوبا ,المدرسة الرسمية - غرفة رقم 1,سني,656,309,5,1,304
حاصبيا,كفرشوبا ,المدرسة الرسمية - غرفة رقم 2,سني,616,245,3,1,242
حاصبيا,كفرشوبا ,المدرسة الرسمية - غرفة رقم 3,سني,625,265,3,4,262
حاصبيا,كفرشوبا ,المدرسة الرسمية - غرفة رقم 4,مختلف,611,240,1,5,239
حاصبيا,كفرشوبا ,المدرسة الرسمية - غرفة رقم 5,سني,682,372,7,2,365
حاصبيا,كفرشوبا ,المدرسة الرسمية - غرفة رقم 6,سني,646,279,4,3,275
حاصبيا,كفرشوبا ,المدرسة الرسمية - غرفة رقم 7,سني,662,335,3,2,332
حاصبيا,كفرشوبا ,المدرسة الرسمية - غرفة رقم 8,مختلف,656,276,3,1,273
حاصبيا,كوكبا ,المدرسة الرسمية - غرفة رقم 1,ماروني,478,172,5,1,167
حاصبيا,كوكبا ,المدرسة الرسمية - غرفة رقم 2,ماروني,473,154,2,1,152
حاصبيا,كوكبا ,المدرسة الرسمية - غرفة رقم 3,ماروني,469,144,0,2,144
حاصبيا,مرج الزهور ,المدرسة الرسمية - غرفة رقم 1,مختلف,568,154,5,1,149
حاصبيا,مرج الزهور ,المدرسة الرسمية - غرفة رقم 2,مختلف,548,195,1,1,194
حاصبيا,ميمس ,المدرسة الرسمية - غرفة رقم 1,درزي,591,272,7,4,265
حاصبيا,ميمس ,المدرسة الرسمية - غرفة رقم 2,درزي,606,322,4,2,318
حاصبيا,ميمس ,المدرسة الرسمية - غرفة رقم 3,مختلف,551,170,1,3,169
راشيا,البيره ,المدرسة الرسمية - غرفة رقم 1,سني,568,165,4,1,161
راشيا,البيره ,المدرسة الرسمية - غرفة رقم 2,سني,546,200,6,0,194
راشيا,البيره ,المدرسة الرسمية - غرفة رقم 3,سني,560,188,7,1,181
راشيا,البيره ,المدرسة الرسمية - غرفة رقم 4,سني,549,188,4,1,184
راشيا,البيره ,المدرسة الرسمية - غرفة رقم 5,سني,531,207,1,1,206
راشيا,البيره ,المدرسة الرسمية - غرفة رقم 6,سني,538,203,0,3,203
راشيا,الحوش ,المدرسة الرسمية - غرفة رقم 1,مسيحي,493,162,4,2,158
راشيا,الحوش ,المدرسة الرسمية - غرفة رقم 2,مسيحي,478,175,7,0,168
راشيا,الرفيد ,المدرسة الرسمية - غرفة رقم 1,سني,618,278,5,2,273
راشيا,الرفيد ,المدرسة الرسمية - غرفة رقم 2,سني,589,237,13,2,224
راشيا,الرفيد ,المدرسة الرسمية - غرفة رقم 3,سني,612,282,14,1,268
راشيا,الرفيد ,المدرسة الرسمية - غرفة رقم 4,سني,602,290,11,2,279
راشيا,الرفيد ,المدرسة الرسمية - غرفة رقم 5,سني,580,242,16,1,226
راشيا,العقبة ,معهد راشيا الفني في بلدة العقبة - غرفة رقم 1,درزي,642,398,13,4,385
راشيا,العقبة ,معهد راشيا الفني في بلدة العقبة - غرفة رقم 2,درزي,602,470,4,3,466
راشيا,العقبة ,معهد راشيا الفني في بلدة العقبة - غرفة رقم 3,درزي,636,437,7,2,430
راشيا,بكا ,المدرسة الرسمية - غرفة رقم 1,سني,529,108,4,0,104
راشيا,بكا ,المدرسة الرسمية - غرفة رقم 2,سني,538,170,8,1,162
راشيا,بكيفا ,النادي الثقافي - غرفة رقم 1,درزي,534,277,4,4,273
راشيا,بكيفا ,دار البلدية - غرفة رقم 1,درزي,531,221,0,4,221
راشيا,بيت لهيا ,مبنى البلدية - غرفة رقم 1,مسيحي,580,198,3,1,195
راشيا,بيت لهيا ,مبنى البلدية - غرفة رقم 2,مسيحي,615,217,11,2,206
راشيا,تنوره ,المدرسة الرسمية - غرفة رقم 1,درزي,382,206,1,7,205
راشيا,تنوره ,المدرسة الرسمية - غرفة رقم 2,درزي,351,276,3,3,273
راشيا,حلوه ,المدرسة الرسمية - غرفة رقم 1,درزي,573,325,2,0,323
راشيا,خربة روحا ,المدرسة الرسمية المبنى الجديد - غرفة رقم 1,سني,650,163,3,0,160
راشيا,خربة روحا ,المدرسة الرسمية المبنى الجديد - غرفة رقم 2,سني,634,170,10,2,160
راشيا,خربة روحا ,المدرسة الرسمية المبنى الجديد - غرفة رقم 3,سني,612,185,8,2,177
راشيا,خربة روحا ,المدرسة الرسمية المبنى الجديد - غرفة رقم 4,سني,620,189,3,3,186
راشيا,خربة روحا ,المدرسة الرسمية المبنى الجديد - غرفة رقم 5,سني,616,182,4,1,178
راشيا,خربة روحا ,المدرسة الرسمية المبنى الجديد - غرفة رقم 6,سني,598,209,3,1,206
راشيا,دير العشائر ,المدرسة الرسمية - غرفة رقم 1,درزي,529,285,7,3,278
راشيا,راشيا حي الفوقا ,دار المعلمين والمعلمات المبنى الجديد - غرفة رقم 1,روم ارثوذكس,361,94,1,0,93
راشيا,راشيا حي الفوقا ,دار المعلمين والمعلمات المبنى الجديد - غرفة رقم 2,روم ارثوذكس,338,102,6,1,96
راشيا,راشيا حي الكواسبه ,ثانوية راشيا الرسمية - غرفة رقم 1,درزي,612,305,3,5,302
راشيا,راشيا حي الكواسبه ,ثانوية راشيا الرسمية - غرفة رقم 2,درزي,620,295,2,8,293
راشيا,راشيا حي الكواسبه ,ثانوية راشيا الرسمية - غرفة رقم 3,درزي,625,376,5,0,371
راشيا,راشيا حي الكواسبه ,ثانوية راشيا الرسمية - غرفة رقم 4,درزي,625,354,2,11,352
راشيا,راشيا حي الكواسبه ,ثانوية راشيا الرسمية - غرفة رقم 5,درزي,605,343,15,3,328
راشيا,راشيا حي الميدان ,ثانوية حرمون الرسمية المبنى الجديد - غرفة رقم 1,روم ارثوذكس,572,129,4,3,125
راشيا,راشيا حي الميدان ,ثانوية حرمون الرسمية المبنى الجديد - غرفة رقم 2,روم ارثوذكس,573,157,1,1,156
راشيا,راشيا حي الميدان ,ثانوية حرمون الرسمية المبنى الجديد - غرفة رقم 3,مسيحي,554,94,0,0,94
راشيا,راشيا حي الميدان ,ثانوية حرمون الرسمية المبنى الجديد - غرفة رقم 4,مسيحي,557,350,9,1,341
راشيا,راشيا حي الميدان ,ثانوية حرمون الرسمية المبنى الجديد - غرفة رقم 5,درزي,587,361,3,2,358
راشيا,سلساتا ,قاعة المسجد - غرفة رقم 1,سني,54,17,3,0,14
راشيا,ضهر الاحمر ,المدرسة الرسمية المتوسطة - غرفة رقم 1,مختلف,555,308,7,6,301
راشيا,ضهر الاحمر ,المدرسة الرسمية المتوسطة - غرفة رقم 2,مختلف,534,375,8,2,367
راشيا,عيتا الفخار ,المدرسة الرسمية لرعية الروم الارثوذكس - غرفة رقم 1,سني,458,213,4,1,209
راشيا,عيتا الفخار ,المدرسة الرسمية لرعية الروم الارثوذكس - غرفة رقم 2,سني,476,255,4,5,251
راشيا,عيتا الفخار ,المدرسة الرسمية لرعية الروم الارثوذكس - غرفة رقم 3,روم ارثوذكس,445,150,7,0,143
راشيا,عيتا الفخار ,المدرسة الرسمية لرعية الروم الارثوذكس - غرفة رقم 4,روم ارثوذكس,443,174,1,0,173
راشيا,عيتا الفخار ,المدرسة الرسمية لرعية الروم الارثوذكس - غرفة رقم 5,روم ارثوذكس,437,139,4,0,135
راشيا,عيتا الفخار ,المدرسة الرسمية لرعية الروم الارثوذكس - غرفة رقم 6,مسيحي,408,135,0,0,135
راشيا,عيحا ,المدرسة الرسمية - غرفة رقم 1,درزي,594,276,7,1,269
راشيا,عيحا ,المدرسة الرسمية - غرفة رقم 2,درزي,581,296,7,0,289
راشيا,عيحا ,المدرسة الرسمية - غرفة رقم 3,درزي,549,300,8,5,292
راشيا,عيحا ,المدرسة الرسمية - غرفة رقم 4,درزي,544,359,2,2,357
راشيا,عيحا ,المدرسة الرسمية - غرفة رقم 5,مختلف,534,250,0,1,250
راشيا,عين حرشا ,المدرسة الرسمية - غرفة رقم 1,مختلف,558,238,7,0,231
راشيا,عين حرشا ,المدرسة الرسمية - غرفة رقم 2,مختلف,580,290,8,5,282
راشيا,عين عرب ,المدرسة الرسمية - غرفة رقم 1,روم ارثوذكس,489,116,0,3,116
راشيا,عين عرب ,المدرسة الرسمية - غرفة رقم 2,روم ارثوذكس,474,133,3,0,130
راشيا,عين عطا ,المدرسة الرسمية المبنى الجديد - غرفة رقم 1,درزي,645,290,6,4,284
راشيا,عين عطا ,المدرسة الرسمية المبنى الجديد - غرفة رقم 2,درزي,666,400,4,6,396
راشيا,عين عطا ,المدرسة الرسمية المبنى الجديد - غرفة رقم 3,مختلف,600,189,7,1,182
راشيا,كفردنيس ,المدرسة الرسمية الجديدة - غرفة رقم 1,سني,658,320,8,10,312
راشيا,كفردنيس ,المدرسة الرسمية الجديدة - غرفة رقم 2,سني,663,407,12,14,395
راشيا,كفرقوق ,المدرسة الرسمية - غرفة رقم 1,درزي,573,273,6,2,267
راشيا,كفرقوق ,المدرسة الرسمية - غرفة رقم 2,مختلف,554,238,1,3,237
راشيا,كفرقوق ,المدرسة الرسمية - غرفة رقم 3,درزي,520,327,6,6,321
راشيا,كفرقوق ,المدرسة الرسمية - غرفة رقم 4,مختلف,504,298,4,3,294
راشيا,كفرمشكي ,المدرسة الرسمية - غرفة رقم 1,روم ارثوذكس,442,46,1,0,45
راشيا,كفرمشكي ,المدرسة الرسمية - غرفة رقم 2,روم ارثوذكس,428,54,1,0,53
راشيا,كفرمشكي ,المدرسة الرسمية - غرفة رقم 3,روم ارثوذكس,443,63,6,2,57
راشيا,كفرمشكي ,المدرسة الرسمية - غرفة رقم 4,روم ارثوذكس,417,61,1,0,60
راشيا,كوكبا ,المدرسة الرسمية - غرفة رقم 1,درزي,628,428,3,1,425
راشيا,مجدل بلهيص ,المدرسة الرسمية - غرفة رقم 1,سني,594,114,3,0,111
راشيا,مجدل بلهيص ,المدرسة الرسمية - غرفة رقم 2,مختلف,623,153,9,2,144
راشيا,مجدل بلهيص ,المدرسة الرسمية - غرفة رقم 3,سني,578,140,0,0,140
راشيا,مجدل بلهيص ,المدرسة الرسمية - غرفة رقم 4,مختلف,559,165,4,0,161
راشيا,محيدثه ,المدرسة الرسمية - غرفة رقم 1,درزي,439,262,4,8,258
راشيا,محيدثه ,المدرسة الرسمية - غرفة رقم 2,درزي,437,299,7,3,292
راشيا,محيدثه ,المدرسة الرسمية - غرفة رقم 3,مختلف,426,243,5,4,238
راشيا,مدوخا ,المدرسة الرسمية - غرفة رقم 1,سني,633,115,1,1,114
راشيا,مدوخا ,المدرسة الرسمية - غرفة رقم 2,سني,617,163,3,3,160
راشيا,مدوخا ,المدرسة الرسمية - غرفة رقم 3,سني,609,115,1,0,114
راشيا,ينطا ,المدرسة الرسمية - غرفة رقم 1,درزي,555,133,0,0,133
راشيا,ينطا ,المدرسة الرسمية - غرفة رقم 2,درزي,548,127,1,0,126
راشيا,ينطا ,المدرسة الرسمية - غرفة رقم 3,درزي,547,186,3,3,183
راشيا,ينطا ,المدرسة الرسمية - غرفة رقم 4,درزي,545,159,3,3,156
زحلة,ابلح ,مدرسة أبلح الرسمية - غرفة رقم 1,روم كاثوليك,544,283,3,1,280
زحلة,ابلح ,مدرسة أبلح الرسمية - غرفة رقم 2,مختلف,563,274,3,1,271
زحلة,ابلح ,مدرسة أبلح الرسمية - غرفة رقم 3,روم كاثوليك,573,346,7,1,339
زحلة,ابلح ,مدرسة أبلح الرسمية - غرفة رقم 4,مختلف,553,316,3,1,313
زحلة,الفرزل التحتا ,مدرسة الراهبات المخلصيات - غرفة رقم 1,روم كاثوليك,614,398,0,2,398
زحلة,الفرزل التحتا ,مدرسة الراهبات المخلصيات - غرفة رقم 2,روم كاثوليك,596,418,2,0,416
زحلة,الفرزل التحتا ,مدرسة الراهبات المخلصيات - غرفة رقم 3,مسيحي,590,336,3,2,333
زحلة,الفرزل التحتا ,مدرسة الراهبات المخلصيات - غرفة رقم 4,مسيحي,605,404,7,2,397
زحلة,الفرزل الفوقا ,المدرسة الرسمية الابتدائية - غرفة رقم 1,روم كاثوليك,494,314,11,1,303
زحلة,الفرزل الفوقا ,المدرسة الرسمية الابتدائية - غرفة رقم 2,روم كاثوليك,470,337,13,2,324
زحلة,الفرزل الفوقا ,المدرسة الرسمية الابتدائية - غرفة رقم 3,مسيحي,494,318,6,0,312
زحلة,الكرمة ,حسينية الكرمة - غرفة رقم 2,مسلم,342,250,8,0,242
زحلة,الوقف ,مدرسة كلينكيان (كابوسيه) - غرفة رقم 3,ارمن  ,426,138,6,6,132
زحلة,بتياس ,المدرسة الانجيلية (يوغون اولوك) - غرفة رقم 1,أرمن ارثوذكس,452,145,3,5,142
زحلة,بتياس ,المدرسة الانجيلية (يوغون اولوك) - غرفة رقم 2,أرمن ارثوذكس,463,152,7,7,145
زحلة,بتياس ,المدرسة الانجيلية (يوغون اولوك) - غرفة رقم 3,مسيحي,441,106,5,5,101
زحلة,بر الياس ,ثانوية بر الياس الرسمية - غرفة رقم 1,سني,553,323,4,3,319
زحلة,بر الياس ,ثانوية بر الياس الرسمية - غرفة رقم 2,سني,568,339,5,2,334
زحلة,بر الياس ,ثانوية بر الياس الرسمية - غرفة رقم 3,سني,564,343,11,2,332
زحلة,بر الياس ,ثانوية بر الياس الرسمية - غرفة رقم 4,سني,587,369,31,0,338
زحلة,بر الياس ,ثانوية بر الياس الرسمية - غرفة رقم 5,سني,547,302,31,2,271
زحلة,بر الياس ,ثانوية بر الياس الرسمية - غرفة رقم 6,سني,544,346,5,2,341
زحلة,بر الياس ,ثانوية بر الياس الرسمية - غرفة رقم 7,سني,553,289,11,4,278
زحلة,بر الياس ,متوسطة بر الياس الرسمية - غرفة رقم 1,مسيحي,452,186,0,1,186
زحلة,بر الياس ,متوسطة بر الياس الرسمية - غرفة رقم 2,مسيحي,453,201,2,0,199
زحلة,بر الياس ,متوسطة بر الياس الرسمية - غرفة رقم 3,سني,569,378,46,5,332
زحلة,بر الياس ,متوسطة بر الياس الرسمية - غرفة رقم 4,سني,543,376,48,7,328
زحلة,بر الياس ,متوسطة بر الياس الرسمية - غرفة رقم 5,مسلم,548,338,13,9,325
زحلة,بر الياس ,مدرسة بر الياس الابتدائية الرسمية - غرفة رقم 1,سني,598,347,9,5,338
زحلة,بر الياس ,مدرسة بر الياس الابتدائية الرسمية - غرفة رقم 2,سني,601,389,6,6,383
زحلة,بر الياس ,مدرسة بر الياس الابتدائية الرسمية - غرفة رقم 3,سني,583,362,11,2,351
زحلة,بر الياس ,مدرسة بر الياس الابتدائية الرسمية - غرفة رقم 4,سني,613,391,32,2,359
زحلة,بر الياس ,مدرسة بر الياس الابتدائية الرسمية - غرفة رقم 5,سني,589,335,9,0,326
زحلة,بر الياس ,مدرسة بر الياس الابتدائية الرسمية - غرفة رقم 6,سني,588,401,7,2,394
زحلة,بر الياس ,مدرسة بر الياس الابتدائية الرسمية - غرفة رقم 7,سني,612,343,2,0,341
زحلة,بوارج ,المدرسة الرسمية - غرفة رقم 1,سني,508,324,4,2,320
زحلة,بوارج ,المدرسة الرسمية - غرفة رقم 2,سني,490,327,14,3,313
زحلة,بوارج ,المدرسة الرسمية - غرفة رقم 3,سني,532,315,9,4,306
زحلة,تربل ,المدرسة الرسمية - غرفة رقم 1,ماروني,636,353,7,0,346
زحلة,تربل ,المدرسة الرسمية - غرفة رقم 2,مسيحي,618,400,5,4,395
زحلة,تربل ,المدرسة الرسمية - غرفة رقم 3,سني,367,183,0,1,183
زحلة,تربل ,مركز البلدية - غرفة رقم 1,مسيحي,622,338,5,0,333
زحلة,تربل ,مركز البلدية - غرفة رقم 2,ماروني,590,427,9,2,418
زحلة,تعلبايا ,تكميلية تعلبايا الرسمية - غرفة رقم 1,مختلف,615,371,5,0,366
زحلة,تعلبايا ,تكميلية تعلبايا الرسمية - غرفة رقم 2,مختلف,634,348,10,0,338
زحلة,تعلبايا ,تكميلية تعلبايا الرسمية - غرفة رقم 3,مختلف,598,336,5,3,331
زحلة,تعلبايا ,تكميلية تعلبايا الرسمية - غرفة رقم 4,مختلف,644,360,5,2,355
زحلة,تعلبايا ,تكميلية تعلبايا الرسمية - غرفة رقم 5,سني,635,348,3,3,345
زحلة,تعلبايا ,تكميلية تعلبايا الرسمية - غرفة رقم 6,سني,609,364,23,0,341
زحلة,تعلبايا ,تكميلية تعلبايا الرسمية - غرفة رقم 7,سني,633,389,7,3,382
زحلة,تعلبايا ,تكميلية تعلبايا الرسمية - غرفة رقم 8,مختلف,561,200,8,0,192
زحلة,تعلبايا ,ثانوية تعلبايا الرسمية - غرفة رقم 1,ماروني,511,257,2,0,255
زحلة,تعلبايا ,ثانوية تعلبايا الرسمية - غرفة رقم 2,ماروني,560,337,8,5,329
زحلة,تعلبايا ,ثانوية تعلبايا الرسمية - غرفة رقم 3,مسيحي,573,313,8,0,305
زحلة,تعنايل ,مركز البلدية - غرفة رقم 1,مختلف,413,285,12,2,273
زحلة,تعنايل ,مركز البلدية - غرفة رقم 2,مختلف,402,277,16,0,261
زحلة,تل الاخضر ,تكميلية قب الياس الرسمية - غرفة رقم 9,سني,105,47,3,0,44
زحلة,تويته ,كنيسة سيدة النياح تويته - غرفة رقم 1,روم كاثوليك,177,123,5,0,118
زحلة,جديتا ,المدرسة الابتدائية الرسمية - غرفة رقم 1,ماروني,564,325,6,2,319
زحلة,جديتا ,المدرسة الابتدائية الرسمية - غرفة رقم 2,ماروني,584,326,1,0,325
زحلة,جديتا ,المدرسة الابتدائية الرسمية - غرفة رقم 3,سني,624,315,10,1,305
زحلة,جديتا ,دار البلدية - غرفة رقم 1,مختلف,584,306,2,2,304
زحلة,جديتا ,دار البلدية - غرفة رقم 2,سني,585,339,17,1,322
زحلة,جديتا ,دار البلدية - غرفة رقم 3,مختلف,588,339,3,3,336
زحلة,جديتا ,دار البلدية - غرفة رقم 4,مسيحي,573,289,4,0,285
زحلة,جلالا ,مركز الأحراج - غرفة رقم 1,مختلف,386,163,1,1,162
زحلة,حاجي حببلي ,مدرسة اغاجانيان - غرفة رقم 1,مسيحي,380,44,2,0,42
زحلة,حاجي حببلي ,مدرسة اغاجانيان - غرفة رقم 2,مسيحي,382,44,1,1,43
زحلة,حزرتا ,معهد حزرتا الفني - غرفة رقم 1,شيعي,564,343,2,1,341
زحلة,حزرتا ,معهد حزرتا الفني - غرفة رقم 2,شيعي,566,374,0,0,374
زحلة,حزرتا ,معهد حزرتا الفني - غرفة رقم 3,شيعي,612,365,5,0,360
زحلة,حزرتا ,معهد حزرتا الفني - غرفة رقم 4,شيعي,592,480,5,0,475
زحلة,حزرتا ,معهد حزرتا الفني - غرفة رقم 5,شيعي,541,420,4,1,416
زحلة,حزرتا ,معهد حزرتا الفني - غرفة رقم 6,شيعي,527,415,3,0,412
زحلة,حوش الغنم ,مدرسة علي النهري الابتدائية الرسمية - غرفة رقم 7,مسلم,348,262,1,1,261
زحلة,حوش حالا ,ثانوية رياق الرسمية - غرفة رقم 1,شيعي,562,361,1,1,360
زحلة,حوش حالا ,ثانوية رياق الرسمية - غرفة رقم 2,مختلف,543,269,4,0,265
زحلة,حوش حالا ,ثانوية رياق الرسمية - غرفة رقم 3,شيعي,547,402,7,1,395
زحلة,حوش حالا ,ثانوية رياق الرسمية - غرفة رقم 4,مختلف,565,335,0,0,335
زحلة,حوش حالا ,متوسطة رياق الرسمية الاولى - غرفة رقم 10,مختلف,516,251,15,0,236
زحلة,حوش حالا ,متوسطة رياق الرسمية الاولى - غرفة رقم 11,روم كاثوليك,521,196,2,0,194
زحلة,حوش حالا ,متوسطة رياق الرسمية الاولى - غرفة رقم 12,مختلف,553,232,13,2,219
زحلة,حوش حالا ,متوسطة رياق الرسمية الاولى - غرفة رقم 7,مسيحي,546,233,10,0,223
زحلة,حوش حالا ,متوسطة رياق الرسمية الاولى - غرفة رقم 8,ماروني,526,268,5,0,263
زحلة,حوش حالا ,متوسطة رياق الرسمية الاولى - غرفة رقم 9,روم كاثوليك,501,192,3,1,189
زحلة,حي السلم ,متوسطة رياق الثانية الرسمية - غرفة رقم 1,شيعي,364,251,3,0,248
زحلة,حي الفيكاني ,المدرسة الرسمية - غرفة رقم 1,شيعي,479,333,1,0,332
زحلة,حي الفيكاني ,المدرسة الرسمية - غرفة رقم 2,شيعي,371,371,7,1,364
زحلة,حي الفيكاني ,المدرسة الرسمية - غرفة رقم 3,مسلم,471,389,7,2,382
زحلة,خضر بك ,مركز بلدية عنجر - غرفة رقم 1,ارمن  ,485,147,4,6,143
زحلة,خضر بك ,نادي الهومنتمن الرياضي - غرفة رقم 1,أرمن ارثوذكس,463,187,2,1,185
زحلة,خضر بك ,نادي الهومنتمن الرياضي - غرفة رقم 2,ارمن  ,449,138,4,5,134
زحلة,خضر بك ,نادي الهومنتمن الرياضي - غرفة رقم 3,أرمن ارثوذكس,495,187,4,0,183
زحلة,دلهميه ,مدرسة الاحسان الوطنية المجانية - غرفة رقم 1,سني,624,348,24,0,324
زحلة,دلهميه ,مدرسة الاحسان الوطنية المجانية - غرفة رقم 2,سني,643,372,34,1,338
زحلة,دلهميه ,مدرسة الاحسان الوطنية المجانية - غرفة رقم 3,سني,582,322,22,3,300
زحلة,دلهميه ,مدرسة الاحسان الوطنية المجانية - غرفة رقم 4,سني,592,293,11,5,282
زحلة,دلهميه ,مدرسة الاحسان الوطنية المجانية - غرفة رقم 5,مختلف,585,314,4,14,310
زحلة,دول إقليمية,دول إقليمية,مختلف,3601,2086,38,13,2048
زحلة,دير الغزال ,المدرسة الرسمية المختلطة - غرفة رقم 1,مختلف,440,237,6,3,231
زحلة,دير الغزال ,المدرسة الرسمية المختلطة - غرفة رقم 2,مختلف,442,256,1,0,255
زحلة,رعيت ,مدرسة رعيت الرسمية - غرفة رقم 1,روم ارثوذكس,574,350,7,0,343
زحلة,رعيت ,مدرسة رعيت الرسمية - غرفة رقم 2,روم ارثوذكس,551,378,5,0,373
زحلة,رعيت ,مدرسة رعيت الرسمية - غرفة رقم 3,مسيحي,575,310,6,0,304
زحلة,رياق ,متوسطة رياق الرسمية الاولى - غرفة رقم 1,مختلف,507,313,1,3,312
زحلة,رياق ,متوسطة رياق الرسمية الاولى - غرفة رقم 2,مختلف,517,334,2,1,332
زحلة,رياق ,متوسطة رياق الرسمية الاولى - غرفة رقم 3,مسيحي,446,216,1,1,215
زحلة,رياق ,متوسطة رياق الرسمية الاولى - غرفة رقم 4,مسيحي,462,235,8,4,227
زحلة,رياق ,متوسطة رياق الرسمية الاولى - غرفة رقم 5,مسيحي,463,207,2,1,205
زحلة,رياق ,متوسطة رياق الرسمية الاولى - غرفة رقم 6,مسيحي,471,244,2,1,242
زحلة,زحلة البرباره ,مدرسة البربارة - غرفة رقم 1,أرمن ارثوذكس,539,128,7,1,121
زحلة,زحلة البرباره ,مدرسة البربارة - غرفة رقم 2,روم كاثوليك,549,223,1,2,222
زحلة,زحلة البرباره ,مدرسة البربارة - غرفة رقم 3,روم كاثوليك,516,217,0,1,217
زحلة,زحلة البرباره ,مدرسة البربارة - غرفة رقم 4,روم كاثوليك,498,152,1,3,151
زحلة,زحلة البرباره ,مدرسة البربارة - غرفة رقم 5,مسيحي,525,196,7,1,189
زحلة,زحلة البرباره ,مدرسة البربارة - غرفة رقم 6,ماروني,495,243,1,2,242
زحلة,زحلة البرباره ,مدرسة البربارة - غرفة رقم 7,ماروني,513,259,2,2,257
زحلة,زحلة البرباره ,مدرسة البربارة - غرفة رقم 8,مسيحي,549,181,2,2,179
زحلة,زحلة الراسيه التحتا ,الثانوية الرسمية للبنات - غرفة رقم 1,روم كاثوليك,537,262,0,0,262
زحلة,زحلة الراسيه التحتا ,الثانوية الرسمية للبنات - غرفة رقم 2,روم كاثوليك,534,214,5,0,209
زحلة,زحلة الراسيه التحتا ,الثانوية الرسمية للبنات - غرفة رقم 3,روم كاثوليك,517,258,1,0,257
زحلة,زحلة الراسيه التحتا ,الثانوية الرسمية للبنات - غرفة رقم 4,مسيحي,545,219,5,1,214
زحلة,زحلة الراسيه التحتا ,الثانوية الرسمية للبنات - غرفة رقم 5,مسيحي,547,272,3,0,269
زحلة,زحلة الراسيه التحتا ,الثانوية الرسمية للبنات - غرفة رقم 6,مسيحي,551,278,12,2,266
زحلة,زحلة الراسيه الفوقا ,ثانوية زحلة الرسمية للبنات - غرفة رقم 1,مسيحي,520,243,3,1,240
زحلة,زحلة الراسيه الفوقا ,ثانوية زحلة الرسمية للبنات - غرفة رقم 2,مسيحي,521,248,0,2,248
زحلة,زحلة الراسيه الفوقا ,ثانوية زحلة الرسمية للبنات - غرفة رقم 3,روم كاثوليك,515,239,2,2,237
زحلة,زحلة الراسيه الفوقا ,ثانوية زحلة الرسمية للبنات - غرفة رقم 4,روم كاثوليك,537,227,5,4,222
زحلة,زحلة الراسيه الفوقا ,ثانوية زحلة الرسمية للبنات - غرفة رقم 5,روم كاثوليك,516,267,7,0,260
زحلة,زحلة الراسيه الفوقا ,ثانوية زحلة الرسمية للبنات - غرفة رقم 6,روم كاثوليك,530,187,2,0,185
زحلة,زحلة الراسيه الفوقا ,ثانوية زحلة الرسمية للبنات - غرفة رقم 7,مسيحي,522,208,1,2,207
زحلة,زحلة الراسيه الفوقا ,ثانوية زحلة الرسمية للبنات - غرفة رقم 8,مسيحي,514,208,4,2,204
زحلة,زحلة المعلقه ,مدرسة المعلقة الرسمية للبنات - غرفة رقم 1,مسيحي,504,197,5,2,192
زحلة,زحلة المعلقه ,مدرسة المعلقة الرسمية للبنات - غرفة رقم 2,روم ارثوذكس,480,174,8,2,166
زحلة,زحلة المعلقه ,مدرسة المعلقة الرسمية للبنات - غرفة رقم 3,ماروني,560,246,3,0,243
زحلة,زحلة المعلقه ,مدرسة المعلقة الرسمية للصبيان كرك نوح - غرفة رقم 1,روم كاثوليك,538,257,6,1,251
زحلة,زحلة المعلقه ,مدرسة المعلقة الرسمية للصبيان كرك نوح - غرفة رقم 2,مختلف,572,343,17,3,326
زحلة,زحلة المعلقه ,مدرسة مار يوسف الصخرة (غربي) - غرفة رقم 1,ماروني,541,246,0,0,246
زحلة,زحلة المعلقه ,مدرسة مار يوسف الصخرة (غربي) - غرفة رقم 2,ماروني,511,268,12,1,256
زحلة,زحلة المعلقه ,مدرسة مار يوسف الصخرة (غربي) - غرفة رقم 3,ماروني,505,237,5,4,232
زحلة,زحلة المعلقه ,مدرسة مار يوسف الصخرة (غربي) - غرفة رقم 4,مسيحي,500,209,2,0,207
زحلة,زحلة المعلقه ,مستشفى زحلة الحكومي (الهراوي) - غرفة رقم 1,سني,522,259,39,2,220
زحلة,زحلة المعلقه ,مستشفى زحلة الحكومي (الهراوي) - غرفة رقم 2,سني,552,288,11,3,277
زحلة,زحلة المعلقه ,مستشفى زحلة الحكومي (الهراوي) - غرفة رقم 3,مختلف,521,213,13,0,200
زحلة,زحلة المعلقه ,مستوصف المعلقه الحكومي - غرفة رقم 1,روم كاثوليك,512,216,1,1,215
زحلة,زحلة المعلقه ,مستوصف المعلقه الحكومي - غرفة رقم 2,مختلف,562,294,3,2,291
زحلة,زحلة المعلقه الشمالي ,مدرسة المعلقة الرسمية للبنات - غرفة رقم 4,شيعي,570,356,10,1,346
زحلة,زحلة المعلقه الشمالي ,مدرسة المعلقة الرسمية للبنات - غرفة رقم 5,شيعي,624,375,6,1,369
زحلة,زحلة المعلقه الشمالي ,مدرسة المعلقة الرسمية للبنات - غرفة رقم 6,شيعي,315617,387,1,0,386
زحلة,زحلة المعلقه الشمالي ,مدرسة المعلقة الرسمية للبنات - غرفة رقم 7,شيعي,603,357,20,0,337
زحلة,زحلة المعلقه الشمالي ,مدرسة المعلقة الرسمية للبنات - غرفة رقم 8,مختلف,578,300,6,1,294
زحلة,زحلة المعلقه الشمالي ,مدرسة المعلقة الرسمية للبنات - غرفة رقم 9,مختلف,602,296,10,2,286
زحلة,زحلة الميدان الشرقي ,المدرسة الرسمية الأولى للبنات - غرفة رقم 1,مسيحي,551,143,7,0,136
زحلة,زحلة الميدان الشرقي ,المدرسة الرسمية الأولى للبنات - غرفة رقم 2,مختلف,551,203,6,0,197
زحلة,زحلة الميدان الشرقي ,المدرسة الرسمية الأولى للبنات - غرفة رقم 3,روم ارثوذكس,518,132,7,4,125
زحلة,زحلة الميدان الشرقي ,المدرسة الرسمية الأولى للبنات - غرفة رقم 4,روم ارثوذكس,514,157,1,1,156
زحلة,زحلة الميدان الشرقي ,المدرسة الرسمية الأولى للبنات - غرفة رقم 5,مسيحي,544,135,5,3,130
زحلة,زحلة الميدان الشرقي ,تكميلية زحله الثانية للصبيان - غرفة رقم 1,مسيحي,564,195,3,1,192
زحلة,زحلة الميدان الشرقي ,تكميلية زحله الثانية للصبيان - غرفة رقم 2,مسيحي,532,177,3,1,174
زحلة,زحلة الميدان الشرقي ,تكميلية زحله الثانية للصبيان - غرفة رقم 3,أرمن ارثوذكس,531,77,0,2,77
زحلة,زحلة الميدان الشرقي ,تكميلية زحله الثانية للصبيان - غرفة رقم 4,أرمن ارثوذكس,524,61,1,0,60
زحلة,زحلة الميدان الشرقي ,تكميلية زحله الثانية للصبيان - غرفة رقم 5,مسيحي,536,196,4,0,192
زحلة,زحلة الميدان الغربي ,ثانوية زحله الرسمية للصبيان - غرفة رقم 1,مسيحي,572,107,4,0,103
زحلة,زحلة الميدان الغربي ,ثانوية زحله الرسمية للصبيان - غرفة رقم 2,مسيحي,524,150,6,0,144
زحلة,زحلة الميدان الغربي ,ثانوية زحله الرسمية للصبيان - غرفة رقم 3,مسيحي,534,161,2,1,159
زحلة,زحلة الميدان الغربي ,ثانوية زحله الرسمية للصبيان - غرفة رقم 4,مسيحي,535,185,3,3,182
زحلة,زحلة الميدان الغربي ,ثانوية زحله الرسمية للصبيان - غرفة رقم 5,مختلف,601,268,13,3,255
زحلة,زحلة الميدان الغربي ,ثانوية زحله الرسمية للصبيان - غرفة رقم 6,سريان ارثوذكس,540,188,3,1,185
زحلة,زحلة الميدان الغربي ,ثانوية زحله الرسمية للصبيان - غرفة رقم 7,سريان ارثوذكس,538,178,4,0,174
زحلة,زحلة الميدان الغربي ,ثانوية زحله الرسمية للصبيان - غرفة رقم 8,سريان ارثوذكس,559,199,5,0,194
زحلة,زحلة الميدان الغربي ,ثانوية زحله الرسمية للصبيان - غرفة رقم 9,مسيحي,502,176,11,1,165
زحلة,زحلة حوش الامراء ,مدرسة حوش الأمراء الرسمية - غرفة رقم 1,روم ارثوذكس,554,300,6,2,294
زحلة,زحلة حوش الامراء ,مدرسة حوش الأمراء الرسمية - غرفة رقم 10,ماروني,595,301,3,2,298
زحلة,زحلة حوش الامراء ,مدرسة حوش الأمراء الرسمية - غرفة رقم 11,مختلف,580,314,7,0,307
زحلة,زحلة حوش الامراء ,مدرسة حوش الأمراء الرسمية - غرفة رقم 12,مختلف,342,342,14,2,328
زحلة,زحلة حوش الامراء ,مدرسة حوش الأمراء الرسمية - غرفة رقم 13,مختلف,569,285,12,0,273
زحلة,زحلة حوش الامراء ,مدرسة حوش الأمراء الرسمية - غرفة رقم 2,روم كاثوليك,568,295,3,2,292
زحلة,زحلة حوش الامراء ,مدرسة حوش الأمراء الرسمية - غرفة رقم 3,مسيحي,578,314,0,1,314
زحلة,زحلة حوش الامراء ,مدرسة حوش الأمراء الرسمية - غرفة رقم 4,مختلف,586,325,3,2,322
زحلة,زحلة حوش الامراء ,مدرسة حوش الأمراء الرسمية - غرفة رقم 5,شيعي,648,357,30,3,327
زحلة,زحلة حوش الامراء ,مدرسة حوش الأمراء الرسمية - غرفة رقم 6,شيعي,604,337,11,1,326
زحلة,زحلة حوش الامراء ,مدرسة حوش الأمراء الرسمية - غرفة رقم 7,ماروني,567,300,2,3,298
زحلة,زحلة حوش الامراء ,مدرسة حوش الأمراء الرسمية - غرفة رقم 8,ماروني,580,307,22,0,285
زحلة,زحلة حوش الامراء ,مدرسة حوش الأمراء الرسمية - غرفة رقم 9,ماروني,563,311,7,1,304
زحلة,زحلة حوش الزراعنه ,مدرسة زحلة الثالثة للصبيان (مار فرام) - غرفة رقم 1,روم ارثوذكس,555,243,4,1,239
زحلة,زحلة حوش الزراعنه ,مدرسة زحلة الثالثة للصبيان (مار فرام) - غرفة رقم 2,روم ارثوذكس,567,248,4,2,244
زحلة,زحلة حوش الزراعنه ,مدرسة زحلة الثالثة للصبيان (مار فرام) - غرفة رقم 3,ماروني,558,252,4,0,248
زحلة,زحلة حوش الزراعنه ,مدرسة زحلة الثالثة للصبيان (مار فرام) - غرفة رقم 4,مسيحي,578,234,1,2,233
زحلة,زحلة حوش الزراعنه ,مدرسة زحلة الثالثة للصبيان (مار فرام) - غرفة رقم 5,روم كاثوليك,586,230,10,0,220
زحلة,زحلة حوش الزراعنه ,مدرسة زحلة الثالثة للصبيان (مار فرام) - غرفة رقم 6,روم كاثوليك,537,212,2,1,210
زحلة,زحلة حوش الزراعنه ,مدرسة زحلة الثالثة للصبيان (مار فرام) - غرفة رقم 7,مسيحي,535,205,8,2,197
زحلة,زحلة حوش الزراعنه ,مدرسة زحلة الثالثة للصبيان (مار فرام) - غرفة رقم 8,مسيحي,586,248,2,0,246
زحلة,زحلة حي السيدة ,مبنى الكشاف السرياني في المدينة الصناعية - غرفة رقم 1,سريان ارثوذكس,547,310,14,1,296
زحلة,زحلة حي السيدة ,مبنى الكشاف السرياني في المدينة الصناعية - غرفة رقم 2,سريان ارثوذكس,531,339,21,0,318
زحلة,زحلة حي السيدة ,مبنى الكشاف السرياني في المدينة الصناعية - غرفة رقم 3,مسيحي,530,342,7,1,335
زحلة,زحلة سيدة النجاة ,المتوسطة الاولى الرسمية للصبيان - غرفة رقم 1,مسيحي,495,224,2,1,222
زحلة,زحلة سيدة النجاة ,المتوسطة الاولى الرسمية للصبيان - غرفة رقم 2,مسيحي,496,253,4,0,249
زحلة,زحلة سيدة النجاة ,المتوسطة الاولى الرسمية للصبيان - غرفة رقم 3,مسيحي,454,249,6,0,243
زحلة,زحلة سيدة النجاة ,المتوسطة الاولى الرسمية للصبيان - غرفة رقم 4,مسيحي,517,255,3,1,252
زحلة,زحلة سيدة النجاة ,المتوسطة الاولى الرسمية للصبيان - غرفة رقم 5,مسيحي,501,206,15,1,191
زحلة,زحلة سيدة النجاة ,المتوسطة الاولى الرسمية للصبيان - غرفة رقم 6,مسيحي,513,241,7,3,234
زحلة,زحلة كرك نوح ,تكميلية المعلقه الرسمية للصبيان - غرفة رقم 1,شيعي,553,288,4,0,284
زحلة,زحلة كرك نوح ,تكميلية المعلقه الرسمية للصبيان - غرفة رقم 2,مختلف,511,266,2,1,264
زحلة,زحلة كرك نوح ,تكميلية المعلقه الرسمية للصبيان - غرفة رقم 3,مختلف,536,307,8,1,299
زحلة,زحلة كرك نوح ,تكميلية المعلقه الرسمية للصبيان - غرفة رقم 4,شيعي,567,330,5,3,325
زحلة,زحلة كرك نوح ,تكميلية المعلقه الرسمية للصبيان - غرفة رقم 5,مختلف,564,321,10,1,311
زحلة,زحلة كرك نوح ,تكميلية المعلقه الرسمية للصبيان - غرفة رقم 6,مختلف,587,360,5,0,355
زحلة,زحلة مار الياس ,مدرسة زحلة الفنية حي مار الياس - غرفة رقم 1,روم كاثوليك,514,243,0,1,243
زحلة,زحلة مار الياس ,مدرسة زحلة الفنية حي مار الياس - غرفة رقم 10,مختلف,492,193,1,2,192
زحلة,زحلة مار الياس ,مدرسة زحلة الفنية حي مار الياس - غرفة رقم 2,روم كاثوليك,486,180,3,1,177
زحلة,زحلة مار الياس ,مدرسة زحلة الفنية حي مار الياس - غرفة رقم 3,مسيحي,523,208,1,0,207
زحلة,زحلة مار الياس ,مدرسة زحلة الفنية حي مار الياس - غرفة رقم 4,روم كاثوليك,478,246,3,6,243
زحلة,زحلة مار الياس ,مدرسة زحلة الفنية حي مار الياس - غرفة رقم 5,روم كاثوليك,487,184,0,1,184
زحلة,زحلة مار الياس ,مدرسة زحلة الفنية حي مار الياس - غرفة رقم 6,مختلف,467,140,6,0,134
زحلة,زحلة مار الياس ,مدرسة زحلة الفنية حي مار الياس - غرفة رقم 7,مختلف,527,269,4,1,265
زحلة,زحلة مار الياس ,مدرسة زحلة الفنية حي مار الياس - غرفة رقم 8,مسيحي,464,226,5,0,221
زحلة,زحلة مار الياس ,مدرسة زحلة الفنية حي مار الياس - غرفة رقم 9,مسيحي,465,254,6,2,248
زحلة,زحلة مار انطونيوس ,وقف كنيسة مار انطونيوس - غرفة رقم 1,ماروني,463,235,7,1,228
زحلة,زحلة مار انطونيوس ,وقف كنيسة مار انطونيوس - غرفة رقم 2,ماروني,447,253,3,1,250
زحلة,زحلة مار انطونيوس ,وقف كنيسة مار انطونيوس - غرفة رقم 3,مسيحي,435,187,5,0,182
زحلة,زحلة مار انطونيوس ,وقف كنيسة مار انطونيوس - غرفة رقم 4,مسيحي,421,138,5,1,133
زحلة,زحلة مار مخايل ,غرفة الصناعة والتجارة - غرفة رقم 1,ماروني,581,307,5,0,302
زحلة,زحلة مار مخايل ,غرفة الصناعة والتجارة - غرفة رقم 2,مسيحي,583,231,2,0,229
زحلة,زحلة مار مخايل ,غرفة الصناعة والتجارة - غرفة رقم 3,روم كاثوليك,581,289,3,1,286
زحلة,زحلة مار مخايل ,غرفة الصناعة والتجارة - غرفة رقم 4,روم كاثوليك,550,196,3,1,193
زحلة,زحلة مار مخايل ,غرفة الصناعة والتجارة - غرفة رقم 5,روم كاثوليك,581,318,4,1,314
زحلة,زحلة مار مخايل ,غرفة الصناعة والتجارة - غرفة رقم 6,روم كاثوليك,567,215,9,0,206
زحلة,زحلة مار مخايل ,غرفة الصناعة والتجارة - غرفة رقم 7,مختلف,572,240,5,3,235
زحلة,زحلة مار مخايل ,غرفة الصناعة والتجارة - غرفة رقم 8,مسيحي,545,90,6,0,84
زحلة,زحلة موظفون ,سراي زحلة - غرفة رقم 1,مختلف,300,283,3,7,280
زحلة,زحلة موظفون ,سراي زحلة - غرفة رقم 2,مختلف,310,287,10,12,277
زحلة,زحلة وادي العرايش ,المدرسة الرسمية المختلطة - غرفة رقم 1,ماروني,578,354,4,1,350
زحلة,زحلة وادي العرايش ,المدرسة الرسمية المختلطة - غرفة رقم 2,ماروني,593,368,9,2,359
زحلة,زحلة وادي العرايش ,المدرسة الرسمية المختلطة - غرفة رقم 3,مسيحي,611,332,7,0,325
زحلة,سعدنايل ,المدرسة الرسمية المختلطة - غرفة رقم 1,سني,562,328,6,2,322
زحلة,سعدنايل ,المدرسة الرسمية المختلطة - غرفة رقم 10,سني,0,0,0,0,0
زحلة,سعدنايل ,المدرسة الرسمية المختلطة - غرفة رقم 2,سني,575,333,5,4,328
زحلة,سعدنايل ,المدرسة الرسمية المختلطة - غرفة رقم 3,سني,534,290,2,3,288
زحلة,سعدنايل ,المدرسة الرسمية المختلطة - غرفة رقم 4,سني,600,340,14,2,326
زحلة,سعدنايل ,المدرسة الرسمية المختلطة - غرفة رقم 5,سني,573,318,26,1,292
زحلة,سعدنايل ,المدرسة الرسمية المختلطة - غرفة رقم 6,سني,600,345,6,1,339
زحلة,سعدنايل ,المدرسة الرسمية المختلطة - غرفة رقم 7,سني,590,357,2,0,355
زحلة,سعدنايل ,المدرسة الرسمية المختلطة - غرفة رقم 8,سني,560,333,16,1,317
زحلة,سعدنايل ,المدرسة الرسمية المختلطة - غرفة رقم 9,سني,608,345,9,2,336
زحلة,شتوره ,مركز هاتف شتوره - غرفة رقم 1,مختلف,361,168,5,0,163
زحلة,شهابية الفاعور ,بهو الجامع - غرفة رقم 1,سني,543,288,28,0,260
زحلة,شهابية الفاعور ,بهو الجامع - غرفة رقم 2,سني,458,209,18,0,191
زحلة,علي النهري ,المدرسة الابتدائية - غرفة رقم 1,شيعي,628,444,2,1,442
زحلة,علي النهري ,المدرسة الابتدائية - غرفة رقم 2,شيعي,653,442,2,6,440
زحلة,علي النهري ,المدرسة الابتدائية - غرفة رقم 3,شيعي,637,448,12,2,436
زحلة,علي النهري ,المدرسة الابتدائية - غرفة رقم 4,شيعي,661,467,6,4,461
زحلة,علي النهري ,المدرسة الابتدائية - غرفة رقم 5,شيعي,669,454,9,2,445
زحلة,علي النهري ,المدرسة الابتدائية - غرفة رقم 6,شيعي,662,471,9,3,462
زحلة,علي النهري ,تكميلية علي النهري الرسمية - غرفة رقم 1,شيعي,662,415,4,1,411
زحلة,علي النهري ,تكميلية علي النهري الرسمية - غرفة رقم 2,شيعي,672,393,4,0,389
زحلة,علي النهري ,تكميلية علي النهري الرسمية - غرفة رقم 3,شيعي,642,411,1,1,410
زحلة,علي النهري ,تكميلية علي النهري الرسمية - غرفة رقم 4,شيعي,666,415,0,3,415
زحلة,علي النهري ,تكميلية علي النهري الرسمية - غرفة رقم 5,شيعي,648,373,10,3,363
زحلة,عين كفرزبد ,المدرسة الرسمية - غرفة رقم 1,شيعي,575,284,1,0,283
زحلة,عين كفرزبد ,المدرسة الرسمية - غرفة رقم 2,شيعي,551,412,14,0,398
زحلة,عين كفرزبد ,المدرسة الرسمية - غرفة رقم 3,مسيحي,504,272,2,0,270
زحلة,عين كفرزبد ,المدرسة الرسمية - غرفة رقم 4,مسيحي,485,337,10,5,327
زحلة,قاع الريم ,التكميلية الرسمية - غرفة رقم 1,مسيحي,500,286,8,2,278
زحلة,قاع الريم ,التكميلية الرسمية - غرفة رقم 2,مسيحي,464,296,4,3,292
زحلة,قاع الريم ,التكميلية الرسمية - غرفة رقم 3,مسيحي,472,290,2,0,288
زحلة,قاع الريم ,التكميلية الرسمية - غرفة رقم 4,مسيحي,454,285,12,1,273
زحلة,قب الياس التحتا ,تكميلية قب الياس الرسمية - غرفة رقم 1,سني,582,295,10,5,285
زحلة,قب الياس التحتا ,تكميلية قب الياس الرسمية - غرفة رقم 2,سني,565,267,11,4,256
زحلة,قب الياس التحتا ,تكميلية قب الياس الرسمية - غرفة رقم 3,سني,553,271,6,1,265
زحلة,قب الياس التحتا ,تكميلية قب الياس الرسمية - غرفة رقم 4,سني,630,382,3,5,379
زحلة,قب الياس التحتا ,تكميلية قب الياس الرسمية - غرفة رقم 5,سني,580,369,22,3,347
زحلة,قب الياس التحتا ,تكميلية قب الياس الرسمية - غرفة رقم 6,سني,588,329,2,4,327
زحلة,قب الياس التحتا ,تكميلية قب الياس الرسمية - غرفة رقم 7,سني,571,279,0,0,279
زحلة,قب الياس التحتا ,تكميلية قب الياس الرسمية - غرفة رقم 8,سني,595,284,1,2,283
زحلة,قب الياس التحتا ,ثانوية قب الياس الرسمية - غرفة رقم 1,سني,510,189,2,0,187
زحلة,قب الياس التحتا ,ثانوية قب الياس الرسمية - غرفة رقم 2,سني,524,217,7,3,210
زحلة,قب الياس التحتا ,مدرسة قب الياس الابتدائية - غرفة رقم 1,مسيحي,610,333,9,1,324
زحلة,قب الياس التحتا ,مدرسة قب الياس الابتدائية - غرفة رقم 2,مسيحي,607,363,28,1,335
زحلة,قب الياس الفوقا ,ثانوية قب الياس الرسمية - غرفة رقم 3,ماروني,523,239,2,1,237
زحلة,قب الياس الفوقا ,ثانوية قب الياس الرسمية - غرفة رقم 4,مسيحي,485,234,0,1,234
زحلة,قب الياس الفوقا ,ثانوية قب الياس الرسمية - غرفة رقم 5,سني,491,289,2,1,287
زحلة,قب الياس الفوقا ,ثانوية قب الياس الرسمية - غرفة رقم 6,سني,531,295,12,1,283
زحلة,قب الياس الفوقا ,ثانوية قب الياس الرسمية - غرفة رقم 7,مسيحي,452,150,6,1,144
زحلة,قب الياس الفوقا ,ثانوية قب الياس الرسمية - غرفة رقم 8,مسيحي,475,193,2,2,191
زحلة,قب الياس الفوقا ,مدرسة قب الياس الابتدائية الرسمية - غرفة رقم 3,ماروني,480,202,2,3,200
زحلة,قب الياس الفوقا ,مدرسة قب الياس الابتدائية الرسمية - غرفة رقم 4,مسيحي,462,200,1,1,199
زحلة,قوسايا ,دار البلدية - غرفة رقم 1,مسيحي,564,295,8,0,287
زحلة,قوسايا ,دار البلدية - غرفة رقم 2,مسيحي,527,304,8,1,296
زحلة,كابوسية ,مدرسة كلينكيان (كابوسيه) - غرفة رقم 1,مسيحي,438,46,1,1,45
زحلة,كابوسية ,مدرسة كلينكيان (كابوسيه) - غرفة رقم 2,مسيحي,423,50,0,1,50
زحلة,كفرزبد ,التكميلية الرسمية (ملك الدولة) - غرفة رقم 1,روم ارثوذكس,508,245,0,2,245
زحلة,كفرزبد ,التكميلية الرسمية (ملك الدولة) - غرفة رقم 2,روم ارثوذكس,494,298,2,2,296
زحلة,كفرزبد ,التكميلية الرسمية (ملك الدولة) - غرفة رقم 3,روم ارثوذكس,465,260,5,1,255
زحلة,كفرزبد ,التكميلية الرسمية (ملك الدولة) - غرفة رقم 4,سني,519,285,16,1,269
زحلة,كفرزبد ,التكميلية الرسمية (ملك الدولة) - غرفة رقم 5,سني,533,353,16,5,337
زحلة,كفرزبد ,التكميلية الرسمية (ملك الدولة) - غرفة رقم 6,سني,515,390,10,0,380
زحلة,كفرزبد ,التكميلية الرسمية (ملك الدولة) - غرفة رقم 7,سني,500,379,3,0,376
زحلة,كفرزبد ,التكميلية الرسمية (ملك الدولة) - غرفة رقم 8,مختلف,503,306,13,1,293
زحلة,ماسا ,المدرسة الرسمية - غرفة رقم 1,شيعي,561,432,13,0,419
زحلة,مجدل عنجر ,ثانوية مجدل عنجر الرسمية - غرفة رقم 1,سني,611,399,19,8,380
زحلة,مجدل عنجر ,ثانوية مجدل عنجر الرسمية - غرفة رقم 2,سني,613,410,10,2,400
زحلة,مجدل عنجر ,ثانوية مجدل عنجر الرسمية - غرفة رقم 3,سني,635,347,75,4,272
زحلة,مجدل عنجر ,مدرسة المقاصد الخيرية الاسلامية - غرفة رقم 1,سني,622,403,16,1,387
زحلة,مجدل عنجر ,مدرسة المقاصد الخيرية الاسلامية - غرفة رقم 2,سني,639,430,20,3,410
زحلة,مجدل عنجر ,مدرسة المقاصد الخيرية الاسلامية - غرفة رقم 3,سني,629,395,8,3,387
زحلة,مجدل عنجر ,مدرسة مجدل عنجر الابتدائية - غرفة رقم 1,سني,654,380,18,4,362
زحلة,مجدل عنجر ,مدرسة مجدل عنجر الابتدائية - غرفة رقم 2,سني,656,366,11,1,355
زحلة,مجدل عنجر ,مدرسة مجدل عنجر الابتدائية - غرفة رقم 3,سني,643,387,10,5,377
زحلة,مجدل عنجر ,مدرسة مجدل عنجر الابتدائية - غرفة رقم 4,سني,675,398,21,3,377
زحلة,مجدل عنجر ,مدرسة مجدل عنجر الابتدائية - غرفة رقم 5,سني,654,361,22,7,339
زحلة,مجدل عنجر ,مدرسة مجدل عنجر الابتدائية - غرفة رقم 6,سني,631,413,19,7,394
زحلة,مريجات ,المدرسة التكميلية الرسمية - غرفة رقم 1,ماروني,454,214,12,0,202
زحلة,مريجات ,المدرسة التكميلية الرسمية - غرفة رقم 2,مسيحي,455,252,9,1,243
زحلة,مريجات ,المدرسة التكميلية الرسمية - غرفة رقم 3,ماروني,493,239,0,1,239
زحلة,مريجات ,المدرسة التكميلية الرسمية - غرفة رقم 4,مسيحي,471,258,5,0,253
زحلة,مكسه ,التكميلية الرسمية - غرفة رقم 1,مختلف,573,380,9,2,371
زحلة,مكسه ,التكميلية الرسمية - غرفة رقم 2,مختلف,571,404,5,2,399
زحلة,ناصريه ,المدرسة الرسمية - غرفة رقم 1,مختلف,456,298,2,1,296
زحلة,ناصريه ,المدرسة الرسمية - غرفة رقم 2,مختلف,463,316,11,0,305
زحلة,نبي ايلا ,المدرسة الرسمية - غرفة رقم 1,شيعي,462,254,1,0,253
زحلة,نبي ايلا ,المدرسة الرسمية - غرفة رقم 2,شيعي,708,429,15,0,414
زحلة,نبي ايلا ,المدرسة الرسمية - غرفة رقم 3,شيعي,213,113,10,0,103
زحلة,نيحا ,المدرسة الرسمية - غرفة رقم 1,مسيحي,503,267,0,2,267
زحلة,نيحا ,المدرسة الرسمية - غرفة رقم 2,مسيحي,489,310,1,2,309
زحلة,نيحا ,المدرسة الرسمية - غرفة رقم 3,مختلف,466,222,4,3,218
زحلة,وادي الدلم ,مدرسة قب الياس الابتدائية الرسمية - غرفة رقم 5,مسيحي,381,199,4,0,195
زحلة,وادي الدلم ,مدرسة قب الياس الابتدائية الرسمية - غرفة رقم 6,مسيحي,388,219,0,0,219
زحلة,يوغون اولوك ,المدرسة الانجيلية (يوغون اولوك) - غرفة رقم 4,مسيحي,439,126,2,3,124
زحلة,يوغون اولوك ,المدرسة الانجيلية (يوغون اولوك) - غرفة رقم 5,مسيحي,488,148,3,1,145
زغرتا,اجبع ,غرفة الاستثمار في سنترال اجبع - غرفة رقم 1,ماروني,160,44,0,0,44
زغرتا,ارده ,المدرسة الرسمية - غرفة رقم 1,ماروني,561,282,6,3,276
زغرتا,ارده ,المدرسة الرسمية - غرفة رقم 2,ماروني,518,232,0,3,232
زغرتا,ارده ,المدرسة الرسمية - غرفة رقم 3,ماروني,551,324,12,2,312
زغرتا,ارده ,المدرسة الرسمية - غرفة رقم 4,ماروني,583,314,8,0,306
زغرتا,اسلوت ,بهو الكنيسة - غرفة رقم 2,ماروني,334,100,10,2,90
زغرتا,اصنون ,مدرسة اصنون الرسمية - غرفة رقم 1,ماروني,513,217,1,2,216
زغرتا,البحيرة ,قاعة الكنيسة - غرفة رقم 1,ماروني,501,196,7,1,189
زغرتا,البحيرة ,قاعة الكنيسة - غرفة رقم 2,ماروني,493,209,16,1,193
زغرتا,القادريه ,الثانوية الرسمية في مرياطه - غرفة رقم 5,سني,539,248,32,5,216
زغرتا,القادريه ,الثانوية الرسمية في مرياطه - غرفة رقم 6,سني,489,198,8,3,190
زغرتا,القادريه ,الثانوية الرسمية في مرياطه - غرفة رقم 7,سني,514,216,16,8,200
زغرتا,القادريه ,الثانوية الرسمية في مرياطه - غرفة رقم 8,سني,490,181,8,7,173
زغرتا,ايطو ,نادي شبيبة ايطو السابق - غرفة رقم 1,ماروني,528,139,1,1,138
زغرتا,ايطو ,نادي شبيبة ايطو السابق - غرفة رقم 2,ماروني,537,166,5,2,161
زغرتا,ايعال ,المدرسة الرسمية - غرفة رقم 1,سني,524,159,2,1,157
زغرتا,ايعال ,المدرسة الرسمية - غرفة رقم 2,سني,506,155,4,3,151
زغرتا,بسلوقيط ,صالون كنيسة مار سركيس وباخوس - غرفة رقم 1,ماروني,400,78,0,0,78
زغرتا,بسلوقيط ,صالون كنيسة مار سركيس وباخوس - غرفة رقم 2,ماروني,360,76,4,0,72
زغرتا,بشنين ,قاعة كنيسة مار مخائيل / بشنين - غرفة رقم 1,ماروني,187,122,1,0,121
زغرتا,بنشعي ,بهو كنيسة مار روحانا - غرفة رقم 1,ماروني,400,105,3,2,102
زغرتا,بوسيط ,قاعة الكنيسة - غرفة رقم 1,روم ارثوذكس,343,219,4,1,215
زغرتا,بيت عبيد ,مدرسة المطران المارونية في بلدة ارده - غرفة رقم 1,ماروني,165,58,0,1,58
زغرتا,بيت عوكر ,القاعة الكنيسة - غرفة رقم 1,ماروني,312,156,0,1,156
زغرتا,تولا ,بهو الكنيسة - غرفة رقم 1,ماروني,516,181,3,0,178
زغرتا,تولا ,مركز البلدية - غرفة رقم 1,ماروني,547,254,2,3,252
زغرتا,حارة الفوار ,المدرسة الرسمية - غرفة رقم 1,سني,471,261,9,0,252
زغرتا,حارة الفوار ,المدرسة الرسمية - غرفة رقم 2,سني,494,330,6,0,324
زغرتا,حارة الفوار ,المدرسة الرسمية - غرفة رقم 3,سني,490,285,2,3,283
زغرتا,حارة الفوار ,المدرسة الرسمية - غرفة رقم 4,سني,506,318,2,2,316
زغرتا,حرف ارده ,المدرسة الرسمية - غرفة رقم 1,ماروني,591,309,4,2,305
زغرتا,حرف ارده ,المدرسة الرسمية - غرفة رقم 2,ماروني,586,379,3,6,376
زغرتا,حرف مزيارة ,صالة الكنيسة - غرفة رقم 1,ماروني,372,218,5,0,213
زغرتا,حرف مزيارة ,صالة الكنيسة - غرفة رقم 2,ماروني,401,254,5,1,249
زغرتا,حريقص ,المدرسة الرسمية - غرفة رقم 1,مختلف,661,388,1,4,387
زغرتا,حميص ,صالون كنيسة مار الياس - غرفة رقم 1,ماروني,567,197,2,0,195
زغرتا,حيلان ,قاعة جامع الحميدي - غرفة رقم 1,سني,645,325,9,4,316
زغرتا,حيلان ,قاعة جامع الحميدي - غرفة رقم 2,سني,648,321,7,12,314
زغرتا,حيلان ,قاعة جامع الحميدي - غرفة رقم 3,مختلف,559,206,5,0,201
زغرتا,داريا ,قاعة كنيسة سيدة داريا - غرفة رقم 1,ماروني,561,151,0,1,151
زغرتا,داريا ,قاعة كنيسة سيدة داريا - غرفة رقم 2,ماروني,544,149,6,3,143
زغرتا,دول إقليمية,دول إقليمية,مختلف,4278,2853,66,11,2787
زغرتا,راسكيفا ,مركز البلدية - غرفة رقم 1,مسيحي,317,79,0,2,79
زغرتا,راسكيفا ,مركز البلدية - غرفة رقم 2,مسيحي,350,124,6,0,118
زغرتا,رشعين ,المدرسة الرسمية - غرفة رقم 1,ماروني,627,354,16,2,338
زغرتا,رشعين ,المدرسة الرسمية - غرفة رقم 2,ماروني,663,409,3,2,406
زغرتا,رشعين ,المدرسة الرسمية - غرفة رقم 3,ماروني,604,256,4,1,252
زغرتا,رشعين ,المدرسة الرسمية - غرفة رقم 4,ماروني,608,393,3,8,390
زغرتا,رشعين ,المدرسة الرسمية - غرفة رقم 5,ماروني,653,446,4,3,442
زغرتا,رشعين ,المدرسة الرسمية - غرفة رقم 6,ماروني,619,316,22,2,294
زغرتا,زغرتا حي السيدة الشرقي ,التكميلية الثانية للصبيان - غرفة رقم 1,ماروني,544,276,1,6,275
زغرتا,زغرتا حي السيدة الشرقي ,التكميلية الثانية للصبيان - غرفة رقم 2,ماروني,549,268,1,2,267
زغرتا,زغرتا حي السيدة الشرقي ,التكميلية الثانية للصبيان - غرفة رقم 3,ماروني,532,259,3,3,256
زغرتا,زغرتا حي السيدة الشرقي ,التكميلية الثانية للصبيان - غرفة رقم 4,ماروني,511,298,2,4,296
زغرتا,زغرتا حي السيدة الشرقي ,مدرسة راهبات المحبة - غرفة رقم 1,ماروني,513,314,1,2,313
زغرتا,زغرتا حي السيدة الشرقي ,مدرسة راهبات المحبة - غرفة رقم 2,ماروني,557,316,1,3,315
زغرتا,زغرتا حي السيدة الشرقي ,مدرسة راهبات المحبة - غرفة رقم 3,ماروني,595,214,2,1,212
زغرتا,زغرتا حي السيدة الغربي ,التكميلية الثانية للبنات(مدرسة مدام بدره الرسمية للبنات) - غرفة رقم 1,ماروني,539,260,6,3,254
زغرتا,زغرتا حي السيدة الغربي ,التكميلية الثانية للبنات(مدرسة مدام بدره الرسمية للبنات) - غرفة رقم 2,ماروني,511,271,3,1,268
زغرتا,زغرتا حي السيدة الغربي ,التكميلية الثانية للبنات(مدرسة مدام بدره الرسمية للبنات) - غرفة رقم 3,ماروني,543,224,3,1,221
زغرتا,زغرتا حي السيدة الغربي ,التكميلية الثانية للبنات(مدرسة مدام بدره الرسمية للبنات) - غرفة رقم 4,ماروني,564,314,10,6,304
زغرتا,زغرتا حي السيدة الغربي ,التكميلية الثانية للبنات(مدرسة مدام بدره الرسمية للبنات) - غرفة رقم 5,ماروني,523,315,1,5,314
زغرتا,زغرتا حي السيدة الغربي ,التكميلية الثانية للبنات(مدرسة مدام بدره الرسمية للبنات) - غرفة رقم 6,ماروني,567,244,3,1,241
زغرتا,زغرتا حي الصليب الجنوبي ,التكميلية الأولى للبنات - غرفة رقم 1,ماروني,639,349,10,1,339
زغرتا,زغرتا حي الصليب الجنوبي ,التكميلية الأولى للبنات - غرفة رقم 2,ماروني,640,334,10,0,324
زغرتا,زغرتا حي الصليب الجنوبي ,التكميلية الأولى للبنات - غرفة رقم 3,ماروني,648,368,0,6,368
زغرتا,زغرتا حي الصليب الجنوبي ,التكميلية الأولى للبنات - غرفة رقم 4,ماروني,610,263,6,2,257
زغرتا,زغرتا حي الصليب الجنوبي ,ثانوية زغرتا - غرفة رقم 1,ماروني,650,370,10,3,360
زغرتا,زغرتا حي الصليب الجنوبي ,ثانوية زغرتا - غرفة رقم 2,ماروني,648,388,2,3,386
زغرتا,زغرتا حي الصليب الجنوبي ,ثانوية زغرتا - غرفة رقم 3,ماروني,646,404,4,6,400
زغرتا,زغرتا حي الصليب الجنوبي ,ثانوية زغرتا - غرفة رقم 4,ماروني,6981,349,2,3,347
زغرتا,زغرتا حي الصليب الشمالي ,	 مكتب التنظيم المدني / مبنى السراي - غرفة رقم 1,ماروني,589,348,6,11,342
زغرتا,زغرتا حي الصليب الشمالي ,	 مكتب مالية زغرتا / مبنى السراي - غرفة رقم 1,ماروني,581,268,2,7,266
زغرتا,زغرتا حي الصليب الشمالي ,	 مكتب مالية زغرتا / مبنى السراي - غرفة رقم 2,ماروني,544,308,5,4,303
زغرتا,زغرتا حي الصليب الشمالي ,مكتب الدفاع المدني / مبنى السراي - غرفة رقم 1,ماروني,575,302,3,3,299
زغرتا,زغرتا حي الصليب الشمالي ,مكتب الزراعة /مبنى السراي - غرفة رقم 1,ماروني,584,324,3,11,321
زغرتا,زغرتا حي الصليب الشمالي ,مكتب الصحة / مبنى السراي - غرفة رقم 1,ماروني,586,362,13,7,349
زغرتا,زغرتا حي الصليب الشمالي ,مكتب العقاري المعاون/ مبنى السراي - غرفة رقم 1,مسيحي,571,269,5,1,264
زغرتا,زغرتا حي المعاصر ,التكميلية الاولى للصبيان(تكميلية طوني فرنجيه للصبيان) - غرفة رقم 1,ماروني,579,324,3,2,321
زغرتا,زغرتا حي المعاصر ,التكميلية الاولى للصبيان(تكميلية طوني فرنجيه للصبيان) - غرفة رقم 10,ماروني,592,232,1,3,231
زغرتا,زغرتا حي المعاصر ,التكميلية الاولى للصبيان(تكميلية طوني فرنجيه للصبيان) - غرفة رقم 11,مختلف,581,263,4,2,259
زغرتا,زغرتا حي المعاصر ,التكميلية الاولى للصبيان(تكميلية طوني فرنجيه للصبيان) - غرفة رقم 2,ماروني,593,313,2,3,311
زغرتا,زغرتا حي المعاصر ,التكميلية الاولى للصبيان(تكميلية طوني فرنجيه للصبيان) - غرفة رقم 3,ماروني,620,321,3,3,318
زغرتا,زغرتا حي المعاصر ,التكميلية الاولى للصبيان(تكميلية طوني فرنجيه للصبيان) - غرفة رقم 4,ماروني,607,354,9,4,345
زغرتا,زغرتا حي المعاصر ,التكميلية الاولى للصبيان(تكميلية طوني فرنجيه للصبيان) - غرفة رقم 5,ماروني,588,188,2,0,186
زغرتا,زغرتا حي المعاصر ,التكميلية الاولى للصبيان(تكميلية طوني فرنجيه للصبيان) - غرفة رقم 6,ماروني,603,397,9,4,388
زغرتا,زغرتا حي المعاصر ,التكميلية الاولى للصبيان(تكميلية طوني فرنجيه للصبيان) - غرفة رقم 7,ماروني,616,357,1,4,356
زغرتا,زغرتا حي المعاصر ,التكميلية الاولى للصبيان(تكميلية طوني فرنجيه للصبيان) - غرفة رقم 8,ماروني,597,360,4,7,356
زغرتا,زغرتا حي المعاصر ,التكميلية الاولى للصبيان(تكميلية طوني فرنجيه للصبيان) - غرفة رقم 9,ماروني,599,392,2,6,390
زغرتا,زغرتا موظفون ,سراي زغرتا - غرفة رقم 1,مختلف,248,236,3,8,233
زغرتا,سبعل ,المدرسة الرسمية(راشيل اده) المبنى القديم مقابل الكنيسة - غرفة رقم 1,ماروني,627,162,5,2,157
زغرتا,سبعل ,المدرسة الرسمية(راشيل اده) المبنى القديم مقابل الكنيسة - غرفة رقم 2,ماروني,618,122,0,0,122
زغرتا,سبعل ,المدرسة الرسمية(راشيل اده) المبنى القديم مقابل الكنيسة - غرفة رقم 3,ماروني,627,175,1,4,174
زغرتا,سبعل ,المدرسة الرسمية(راشيل اده) المبنى القديم مقابل الكنيسة - غرفة رقم 4,ماروني,618,148,0,0,148
زغرتا,سبعل ,المدرسة الرسمية(راشيل اده) المبنى القديم مقابل الكنيسة - غرفة رقم 5,ماروني,584,23,0,0,23
زغرتا,سرعل ,المدرسة الرسمية - غرفة رقم 1,ماروني,440,72,0,1,72
زغرتا,سرعل ,المدرسة الرسمية - غرفة رقم 2,ماروني,452,97,1,1,96
زغرتا,سرعل ,المدرسة الرسمية - غرفة رقم 3,ماروني,461,128,0,1,128
زغرتا,عربة قزحيا ,البيت الاجتماعي قرب البلدية - غرفة رقم 1,ماروني,371,109,0,0,109
زغرتا,عربة قزحيا ,البيت الاجتماعي قرب البلدية - غرفة رقم 2,ماروني,389,130,1,1,129
زغرتا,عرجس ,مبنى البلدية الجديد - غرفة رقم 1,ماروني,437,95,2,1,93
زغرتا,عرجس ,مبنى البلدية الجديد - غرفة رقم 2,ماروني,381,94,0,1,94
زغرتا,عشاش ,دير عشاش - غرفة رقم 1,ماروني,452,189,0,0,189
زغرتا,عشاش ,دير عشاش - غرفة رقم 2,ماروني,459,196,4,1,192
زغرتا,عشاش ,دير عشاش - غرفة رقم 3,مختلف,429,198,5,1,193
زغرتا,علما ,المدرسة الرسمية - غرفة رقم 1,ماروني,589,244,2,4,242
زغرتا,علما ,المدرسة الرسمية - غرفة رقم 2,ماروني,606,324,11,5,313
زغرتا,علما ,المدرسة الرسمية - غرفة رقم 3,ماروني,589,305,11,1,294
زغرتا,علما ,المدرسة الرسمية - غرفة رقم 4,ماروني,646,332,16,2,316
زغرتا,عينطورين ,قاعة الكنيسة - غرفة رقم 1,ماروني,554,122,5,0,117
زغرتا,عينطورين ,قاعة الكنيسة - غرفة رقم 2,ماروني,459,128,1,1,127
زغرتا,قره باش ,قاعة الكنيسة - غرفة رقم 1,مسيحي,430,85,1,2,84
زغرتا,قره باش ,قاعة الكنيسة - غرفة رقم 2,مسيحي,384,93,1,0,92
زغرتا,كرم سده ,روضة كرم سده الرسمية - غرفة رقم 1,ماروني,644,255,6,2,249
زغرتا,كرم سده ,روضة كرم سده الرسمية - غرفة رقم 2,ماروني,593,214,6,3,208
زغرتا,كفر حورا ,بهو كنيسة سيدة الانتقال - غرفة رقم 1,ماروني,554,212,2,0,210
زغرتا,كفر دلاقوس ,بهو كنيسة سيدة لورد - غرفة رقم 1,ماروني,445,155,3,4,152
زغرتا,كفر دلاقوس ,بهو كنيسة سيدة لورد - غرفة رقم 2,ماروني,450,195,8,0,187
زغرتا,كفر دلاقوس ,بهو كنيسة سيدة لورد - غرفة رقم 3,ماروني,509,186,3,2,183
زغرتا,كفر زينا ,المدرسة المتوسطة الرسمية - غرفة رقم 1,ماروني,515,151,0,1,151
زغرتا,كفر زينا ,المدرسة المتوسطة الرسمية - غرفة رقم 2,ماروني,477,166,3,5,163
زغرتا,كفر شخنا ,قاعة كنيسة مار جرجس - غرفة رقم 1,ماروني,199,85,0,0,85
زغرتا,كفر صغاب ,المدرسة الرسمية في مرح كفرصغاب - غرفة رقم 1,ماروني,619,110,0,1,110
زغرتا,كفر صغاب ,المدرسة الرسمية في مرح كفرصغاب - غرفة رقم 2,ماروني,609,79,1,0,78
زغرتا,كفر صغاب ,المدرسة الرسمية في مرح كفرصغاب - غرفة رقم 3,ماروني,579,68,2,0,66
زغرتا,كفر صغاب ,المدرسة الرسمية في مرح كفرصغاب - غرفة رقم 4,ماروني,590,107,0,1,107
زغرتا,كفر صغاب ,المدرسة الرسمية في مرح كفرصغاب - غرفة رقم 5,ماروني,569,70,1,0,69
زغرتا,كفر صغاب ,المدرسة الرسمية في مرح كفرصغاب - غرفة رقم 6,ماروني,554,62,1,1,61
زغرتا,كفر ياشيت ,مدرسة كفرياشيت - غرفة رقم 1,ماروني,381,114,1,0,113
زغرتا,كفر ياشيت ,مدرسة كفرياشيت - غرفة رقم 2,ماروني,374,129,1,1,128
زغرتا,كفرحاتا ,دار البلدية - غرفة رقم 1,مختلف,636,285,6,5,279
زغرتا,كفرفو ,قاعة كنيسة مار آسيا - غرفة رقم 1,ماروني,164,164,0,0,164
زغرتا,كفريا ,مدرسة المطران المارونية في بلدة إرده - غرفة رقم 2,ماروني,163,103,2,0,101
زغرتا,مجدليا ,مدرسة راهبات العائلة المقدسة المارونيات - غرفة رقم 1,ماروني,620,189,1,2,188
زغرتا,مجدليا ,مدرسة راهبات العائلة المقدسة المارونيات - غرفة رقم 2,ماروني,622,229,2,3,227
زغرتا,مرياطه ,الثانوية الرسمية في مرياطه - غرفة رقم 1,سني,577,293,20,11,273
زغرتا,مرياطه ,الثانوية الرسمية في مرياطه - غرفة رقم 2,سني,570,292,16,10,276
زغرتا,مرياطه ,الثانوية الرسمية في مرياطه - غرفة رقم 3,سني,587,271,26,7,245
زغرتا,مرياطه ,الثانوية الرسمية في مرياطه - غرفة رقم 4,سني,510,238,28,7,210
زغرتا,مزرعة التفاح ,مستوصف وقف مار ضومط - غرفة رقم 1,ماروني,478,144,0,1,144
زغرتا,مزرعة التفاح ,مستوصف وقف مار ضومط - غرفة رقم 2,ماروني,500,164,1,1,163
زغرتا,مزرعة التفاح ,مستوصف وقف مار ضومط - غرفة رقم 3,ماروني,464,125,6,0,119
زغرتا,مزرعة الفريديس ,قاعة الكنيسة - غرفة رقم 1,ماروني,271,122,2,0,120
زغرتا,مزرعة النهر ,صالون كنيسة مار يوسف - غرفة رقم 1,ماروني,317,124,8,0,116
زغرتا,مزرعة حوقا ,المدرسة الرسمية - غرفة رقم 1,ماروني,455,79,1,1,78
زغرتا,مزيارة ,المدرسة الرسمية - غرفة رقم 1,ماروني,550,225,4,0,221
زغرتا,مزيارة ,المدرسة الرسمية - غرفة رقم 2,ماروني,526,256,0,1,256
زغرتا,مزيارة ,المدرسة الرسمية - غرفة رقم 3,ماروني,541,177,2,1,175
زغرتا,مزيارة ,المدرسة الرسمية - غرفة رقم 4,ماروني,547,268,4,1,264
زغرتا,مزيارة ,المدرسة الرسمية - غرفة رقم 5,ماروني,547,298,3,2,295
زغرتا,مزيارة ,المدرسة الرسمية - غرفة رقم 6,ماروني,532,204,3,0,201
صور,ارزون ,الحسينية - غرفة رقم 1,شيعي,531,375,2,8,373
صور,البازوريه ,المدرسة الرسمية المتوسطة - غرفة رقم 1,شيعي,624,319,6,1,313
صور,البازوريه ,المدرسة الرسمية المتوسطة - غرفة رقم 2,شيعي,608,328,5,0,323
صور,البازوريه ,المدرسة الرسمية المتوسطة - غرفة رقم 3,شيعي,653,375,4,4,371
صور,البازوريه ,المدرسة الرسمية المتوسطة - غرفة رقم 4,مسلم,653,341,12,1,329
صور,البازوريه ,ثانوية البازورية - غرفة رقم 1,شيعي,620,307,4,1,303
صور,البازوريه ,ثانوية البازورية - غرفة رقم 2,شيعي,619,271,12,3,259
صور,البازوريه ,ثانوية البازورية - غرفة رقم 3,شيعي,630,288,14,7,274
صور,البازوريه ,ثانوية البازورية - غرفة رقم 4,مسلم,622,281,6,2,275
صور,البرغليه ,مبنى البلدية - غرفة رقم 1,سني,669,143,15,8,128
صور,البرغليه ,مبنى البلدية - غرفة رقم 2,سني,666,172,12,7,160
صور,البرغليه ,مبنى البلدية - غرفة رقم 3,سني,692,189,26,5,163
صور,البرغليه ,مبنى البلدية - غرفة رقم 4,سني,681,246,5,5,241
صور,البساتين ,الثانوية الرسمية للبنات - غرفة رقم 1,شيعي,645,305,2,4,303
صور,البساتين ,الثانوية الرسمية للبنات - غرفة رقم 2,شيعي,630,281,1,0,280
صور,البساتين ,الثانوية الرسمية للبنات - غرفة رقم 3,شيعي,617,328,7,3,321
صور,البساتين ,الثانوية الرسمية للبنات - غرفة رقم 4,شيعي,603,302,6,2,296
صور,البساتين ,الثانوية الرسمية للبنات - غرفة رقم 5,مسلم,591,203,1,3,202
صور,البستان ,مدرسة البستان الرسمية - غرفة رقم 1,سني,531,203,8,6,195
صور,البستان ,مدرسة البستان الرسمية - غرفة رقم 2,سني,570,199,5,7,194
صور,البستان ,مدرسة البستان الرسمية - غرفة رقم 3,مختلف,406,113,5,4,108
صور,البص  قسم 1 ,الثانوية الرسمية للبنات صور - غرفة رقم 7,مسيحي,176,3,1,0,2
صور,البص  قسم 3 ,الثانوية الرسمية للبنات صور - غرفة رقم 7,مختلف,345,75,1,1,74
صور,البص قسم 5 ,الثانوية الرسمية للبنات صور - غرفة رقم 8,مختلف,418,3,0,0,3
صور,البياض ,المدرسة الرسمية - غرفة رقم 1,شيعي,416,219,4,9,215
صور,البياض ,المدرسة الرسمية - غرفة رقم 2,شيعي,403,247,7,4,240
صور,الجبين ,المدرسة الرسمية - غرفة رقم 1,شيعي,542,253,1,0,252
صور,الجبين ,المدرسة الرسمية - غرفة رقم 2.,شيعي,457,262,0,4,262
صور,الجبين ,المدرسة الرسمية - غرفة رقم 3,شيعي,535,272,2,2,270
صور,الحلوسية ,المدرسة الرسمية - غرفة رقم 1,شيعي,667,424,18,7,406
صور,الحلوسية ,المدرسة الرسمية - غرفة رقم 2,شيعي,676,417,8,3,409
صور,الحلوسية ,المدرسة الرسمية - غرفة رقم 3,شيعي,678,404,14,5,390
صور,الحميري ,المدرسة الرسمية - غرفة رقم 1,شيعي,677,390,3,2,387
صور,الحنية ,المدرسة الرسمية - غرفة رقم 1,شيعي,621,264,4,1,260
صور,الرشيديه ,الثانوية الرسمية للبنات صور - غرفة رقم 9,مسيحي,483,1,0,0,1
صور,الرماديه ,مبنى البلدية ( المدرسة الرسمية القديمة) - غرفة رقم 1,شيعي,520,195,2,2,193
صور,الرماديه ,مبنى البلدية ( المدرسة الرسمية القديمة) - غرفة رقم 2,شيعي,529,258,1,1,257
صور,الرماديه ,مبنى البلدية ( المدرسة الرسمية القديمة) - غرفة رقم 3,شيعي,567,285,4,2,281
صور,الزلوطية ,المدرسة الرسمية في يارين - غرفة رقم 5,سني,157,87,3,0,84
صور,السماعية ,المدرسة الرسمية - غرفة رقم 1,شيعي,482,243,8,8,235
صور,السماعية ,المدرسة الرسمية - غرفة رقم 2,شيعي,427,264,1,2,263
صور,الشعيتية ,المدرسة الرسمية - غرفة رقم 1,شيعي,550,292,2,1,290
صور,الشعيتية ,المدرسة الرسمية - غرفة رقم 2,شيعي,552,276,11,2,265
صور,الشعيتية ,المدرسة الرسمية - غرفة رقم 3,شيعي,536,342,4,3,338
صور,الشعيتية ,المدرسة الرسمية - غرفة رقم 4,شيعي,517,303,3,2,300
صور,الشهابية ,الثانوية الرسمية - غرفة رقم 1,شيعي,648,350,2,6,348
صور,الشهابية ,الثانوية الرسمية - غرفة رقم 2,شيعي,622,331,5,4,326
صور,الشهابية ,الثانوية الرسمية - غرفة رقم 3,شيعي,622,373,8,7,365
صور,الشهابية ,الثانوية الرسمية - غرفة رقم 4,شيعي,618,282,8,8,274
صور,الشهابية ,الثانوية الرسمية - غرفة رقم 5,شيعي,618,342,6,4,336
صور,الشهابية ,الثانوية الرسمية - غرفة رقم 6,شيعي,634,407,8,5,399
صور,الشهابية ,الثانوية الرسمية - غرفة رقم 7,شيعي,621,371,5,1,366
صور,الشهابية ,الثانوية الرسمية - غرفة رقم 8,شيعي,602,316,2,2,314
صور,الشهابية ,الثانوية الرسمية - غرفة رقم 9,شيعي,619,319,1,3,318
صور,الظهيرة ,المدرسة الرسمية - غرفة رقم 1,سني,375,142,2,0,140
صور,الظهيرة ,المدرسة الرسمية - غرفة رقم 2,سني,418,187,6,2,181
صور,الكنيسه ,الحسينية - غرفة رقم 1,شيعي,421,152,1,0,151
صور,المالكية ,الحسينية - غرفة رقم 1,شيعي,400,247,1,2,246
صور,المنصوري ,المدرسة الرسمية - غرفة رقم 1,شيعي,628,211,1,5,210
صور,المنصوري ,المدرسة الرسمية - غرفة رقم 2,شيعي,645,243,3,3,240
صور,المنصوري ,المدرسة الرسمية - غرفة رقم 3,شيعي,598,282,0,6,282
صور,المنصوري ,المدرسة الرسمية - غرفة رقم 4,شيعي,586,246,3,7,243
صور,الناقورة ,المدرسة الرسمية - غرفة رقم 1,مختلف,558,280,0,0,280
صور,الناقورة ,المدرسة الرسمية - غرفة رقم 2,شيعي,538,215,1,0,214
صور,الناقورة ,المدرسة الرسمية - غرفة رقم 3,شيعي,503,288,1,1,287
صور,الناقورة ,المدرسة الرسمية - غرفة رقم 4,شيعي,482,215,1,1,214
صور,الناقورة ,المدرسة الرسمية - غرفة رقم 5,مختلف,518,229,3,2,226
صور,باتولية ,الحسينية الجديدة للرجال - غرفة رقم 1,شيعي,499,229,3,0,226
صور,باتولية ,الحسينية الجديدة للرجال - غرفة رقم 2,شيعي,516,272,1,2,271
صور,باتولية ,الحسينية الجديدة للرجال - غرفة رقم 3,شيعي,508,278,3,2,275
صور,باريش ,المدرسة الرسمية - غرفة رقم 1,شيعي,683,331,3,8,328
صور,باريش ,المدرسة الرسمية - غرفة رقم 2,شيعي,378,342,6,4,336
صور,باريش ,المدرسة الرسمية - غرفة رقم 3,شيعي,684,362,6,1,356
صور,باريش ,المدرسة الرسمية - غرفة رقم 4,شيعي,662,377,5,4,372
صور,بافليه ,المدرسة الرسمية - غرفة رقم 1,شيعي,659,382,6,4,376
صور,بافليه ,المدرسة الرسمية - غرفة رقم 2,شيعي,659,370,3,1,367
صور,بافليه ,المدرسة الرسمية - غرفة رقم 3,شيعي,638,356,1,1,355
صور,بثتيات ,الحسينية - غرفة رقم 1,شيعي,266,147,2,0,145
صور,بدياس ,المدرسة الرسمية - غرفة رقم 1,شيعي,594,344,18,5,326
صور,بدياس ,المدرسة الرسمية - غرفة رقم 2,شيعي,583,391,6,9,385
صور,برج الشمالي ,المدرسة المتوسطة الرسمية - غرفة رقم 1,سني,642,287,2,0,285
صور,برج الشمالي ,المدرسة المتوسطة الرسمية - غرفة رقم 2,شيعي,594,340,5,7,335
صور,برج الشمالي ,المدرسة المتوسطة الرسمية - غرفة رقم 3,شيعي,613,366,3,5,363
صور,برج الشمالي ,المدرسة المتوسطة الرسمية - غرفة رقم 4,مسلم,622,376,2,6,374
صور,برج الشمالي ,المدرسة المتوسطة الرسمية - غرفة رقم 5,سني,614,247,11,8,236
صور,برج الشمالي ,المدرسة المتوسطة الرسمية - غرفة رقم 6,شيعي,662,391,3,7,388
صور,برج الشمالي ,المدرسة المتوسطة الرسمية - غرفة رقم 7,شيعي,646,410,4,2,406
صور,برج الشمالي ,المدرسة المتوسطة الرسمية - غرفة رقم 8,مسلم,619,359,4,5,355
صور,برج رحال ,مبنى البلدية الحالي - غرفة رقم 1,شيعي,634,379,3,5,376
صور,برج رحال ,مبنى البلدية الحالي - غرفة رقم 2,شيعي,650,374,11,4,363
صور,برج رحال ,مبنى البلدية الحالي - غرفة رقم 3,شيعي,648,459,3,2,456
صور,برج رحال ,مبنى البلدية الحالي - غرفة رقم 4,شيعي,617,387,7,1,380
صور,برج رحال ,مبنى البلدية الحالي - غرفة رقم 5,شيعي,587,356,2,0,354
صور,جبال البطم ,المدرسة الرسمية - غرفة رقم 1,شيعي,477,223,7,10,216
صور,جبال البطم ,المدرسة الرسمية - غرفة رقم 2,شيعي,493,295,4,8,291
صور,جبال البطم ,المدرسة الرسمية - غرفة رقم 3,شيعي,450,226,2,3,224
صور,جناته ,الحسينية - غرفة رقم 1,شيعي,570,324,1,5,323
صور,جويا ,مجمع المدارس الجديدة متوسطة جويا الأولى المتوسطة الرسمية - غرفة رقم 1,شيعي,595,164,1,0,163
صور,جويا ,مجمع المدارس الجديدة متوسطة جويا الأولى المتوسطة الرسمية - غرفة رقم 10,شيعي,592,186,0,1,186
صور,جويا ,مجمع المدارس الجديدة متوسطة جويا الأولى المتوسطة الرسمية - غرفة رقم 2,شيعي,592,176,4,1,172
صور,جويا ,مجمع المدارس الجديدة متوسطة جويا الأولى المتوسطة الرسمية - غرفة رقم 3,شيعي,582,211,3,1,208
صور,جويا ,مجمع المدارس الجديدة متوسطة جويا الأولى المتوسطة الرسمية - غرفة رقم 4,شيعي,608,232,1,1,231
صور,جويا ,مجمع المدارس الجديدة متوسطة جويا الأولى المتوسطة الرسمية - غرفة رقم 5,شيعي,608,197,2,0,195
صور,جويا ,مجمع المدارس الجديدة متوسطة جويا الأولى المتوسطة الرسمية - غرفة رقم 6,شيعي,615,188,8,0,180
صور,جويا ,مجمع المدارس الجديدة متوسطة جويا الأولى المتوسطة الرسمية - غرفة رقم 7,شيعي,591,176,3,1,173
صور,جويا ,مجمع المدارس الجديدة متوسطة جويا الأولى المتوسطة الرسمية - غرفة رقم 8,شيعي,592,199,1,2,198
صور,جويا ,مجمع المدارس الجديدة متوسطة جويا الأولى المتوسطة الرسمية - غرفة رقم 9,شيعي,570,169,3,2,166
صور,جويا ,مجمع المدارس الجديدة مدرسة جويا الثانية الرسمية - غرفة رقم 1,شيعي,576,197,2,1,195
صور,جويا ,مجمع المدارس الجديدة مدرسة جويا الثانية الرسمية - غرفة رقم 10,شيعي,580,191,2,0,189
صور,جويا ,مجمع المدارس الجديدة مدرسة جويا الثانية الرسمية - غرفة رقم 2,شيعي,573,218,5,2,213
صور,جويا ,مجمع المدارس الجديدة مدرسة جويا الثانية الرسمية - غرفة رقم 3,شيعي,606,290,6,2,284
صور,جويا ,مجمع المدارس الجديدة مدرسة جويا الثانية الرسمية - غرفة رقم 4,شيعي,585,228,1,1,227
صور,جويا ,مجمع المدارس الجديدة مدرسة جويا الثانية الرسمية - غرفة رقم 5,شيعي,598,238,9,3,229
صور,جويا ,مجمع المدارس الجديدة مدرسة جويا الثانية الرسمية - غرفة رقم 6,شيعي,630,259,2,0,257
صور,جويا ,مجمع المدارس الجديدة مدرسة جويا الثانية الرسمية - غرفة رقم 7,شيعي,604,204,9,1,195
صور,جويا ,مجمع المدارس الجديدة مدرسة جويا الثانية الرسمية - غرفة رقم 8,شيعي,603,253,0,4,253
صور,جويا ,مجمع المدارس الجديدة مدرسة جويا الثانية الرسمية - غرفة رقم 9,شيعي,590,218,4,1,214
صور,حناويه ,المدرسة الرسمية - غرفة رقم 1,شيعي,554,204,0,0,204
صور,حناويه ,المدرسة الرسمية - غرفة رقم 2,شيعي,540,180,2,1,178
صور,حناويه ,المدرسة الرسمية - غرفة رقم 3,شيعي,545,264,2,1,262
صور,حناويه ,المدرسة الرسمية - غرفة رقم 4,شيعي,523,245,9,0,236
صور,دبعال ,المدرسة الرسمية - غرفة رقم 1,شيعي,620,380,4,1,376
صور,دبعال ,المدرسة الرسمية - غرفة رقم 2,شيعي,603,359,2,1,357
صور,دبعال ,المدرسة الرسمية - غرفة رقم 3,شيعي,563,331,0,4,331
صور,دردغيا ,قاعة الكنيسة - غرفة رقم 1,روم كاثوليك,474,56,1,0,55
صور,دردغيا ,قاعة الكنيسة - غرفة رقم 2,روم كاثوليك,467,42,2,0,40
صور,دول إقليمية,دول إقليمية,مختلف,4857,2887,67,26,2820
صور,دير عامص ,المدرسة الرسمية - غرفة رقم 1,شيعي,623,289,2,1,287
صور,دير عامص ,المدرسة الرسمية - غرفة رقم 2,شيعي,662,400,4,1,396
صور,دير عامص ,المدرسة الرسمية - غرفة رقم 3,شيعي,554,255,3,0,252
صور,دير قانون النهر ,المدرسة الرسمية - غرفة رقم 1,شيعي,633,323,12,3,311
صور,دير قانون النهر ,المدرسة الرسمية - غرفة رقم 2,شيعي,637,338,3,1,335
صور,دير قانون النهر ,المدرسة الرسمية - غرفة رقم 3,شيعي,657,312,12,7,300
صور,دير قانون النهر ,المدرسة الرسمية - غرفة رقم 4,شيعي,640,379,4,2,375
صور,دير قانون النهر ,المدرسة الرسمية - غرفة رقم 5,شيعي,607,383,3,5,380
صور,دير قانون النهر ,المدرسة الرسمية - غرفة رقم 6,شيعي,621,359,11,4,348
صور,دير قانون راس العين ,مبنى البلدية - غرفة رقم 1,شيعي,658,309,1,2,308
صور,دير قانون راس العين ,مبنى البلدية - غرفة رقم 2,شيعي,651,274,3,0,271
صور,دير قانون راس العين ,مبنى البلدية - غرفة رقم 3,شيعي,606,364,20,1,344
صور,دير قانون راس العين ,مبنى البلدية - غرفة رقم 4,شيعي,588,323,6,0,317
صور,دير كيفا ,المدرسة الرسمية - غرفة رقم 1,شيعي,573,296,5,2,291
صور,دير كيفا ,المدرسة الرسمية - غرفة رقم 2,شيعي,575,297,3,1,294
صور,دير كيفا ,المدرسة الرسمية - غرفة رقم 3,شيعي,559,298,1,4,297
صور,دير كيفا ,المدرسة الرسمية - غرفة رقم 4,شيعي,569,293,9,2,284
صور,رشكنانيه ,المدرسة الرسمية - غرفة رقم 1,شيعي,473,237,0,4,237
صور,رشكنانيه ,المدرسة الرسمية - غرفة رقم 2,شيعي,468,264,5,1,259
صور,زبقين ,المدرسة الرسمية - غرفة رقم 1,شيعي,533,275,3,2,272
صور,زبقين ,المدرسة الرسمية - غرفة رقم 2,شيعي,523,361,4,3,357
صور,زبقين ,المدرسة الرسمية - غرفة رقم 3,شيعي,484,256,1,4,255
صور,سلعا ,المدرسة الرسمية - غرفة رقم 1,شيعي,603,339,4,0,335
صور,سلعا ,المدرسة الرسمية - غرفة رقم 2,شيعي,674,379,1,3,378
صور,سلعا ,المدرسة الرسمية - غرفة رقم 3,شيعي,647,415,9,7,406
صور,شبريحا ,حسينية البلدة - غرفة رقم 1,مختلف,564,326,1,0,325
صور,شبريحا ,حسينية البلدة - غرفة رقم 2,مختلف,515,310,0,0,310
صور,شحور ,متوسطة عفيف بيضون - غرفة رقم 1,شيعي,605,295,0,0,295
صور,شحور ,متوسطة عفيف بيضون - غرفة رقم 2,شيعي,611,258,1,2,257
صور,شحور ,متوسطة عفيف بيضون - غرفة رقم 3,شيعي,610,263,5,2,258
صور,شحور ,متوسطة عفيف بيضون - غرفة رقم 4,شيعي,610,289,8,2,281
صور,شحور ,متوسطة عفيف بيضون - غرفة رقم 5,شيعي,627,327,5,1,322
صور,شحور ,متوسطة عفيف بيضون - غرفة رقم 6,شيعي,642,307,5,1,302
صور,شحور ,متوسطة عفيف بيضون - غرفة رقم 7,شيعي,641,288,5,0,283
صور,شحور ,متوسطة عفيف بيضون - غرفة رقم 8,شيعي,607,287,6,1,281
صور,شمع ,حسينية البلدة - غرفة رقم 1,شيعي,550,207,0,0,207
صور,شمع ,حسينية البلدة - غرفة رقم 2,شيعي,599,267,4,3,263
صور,شيحين ,مدرسة شيحين الرسمية - غرفة رقم 1,مسلم,564,284,2,2,282
صور,شيحين ,مدرسة شيحين الرسمية - غرفة رقم 2,مسلم,531,312,6,2,306
صور,صديقين ,حسينية الرجال و النساء - غرفة رقم 1,شيعي,546,287,3,3,284
صور,صديقين ,حسينية الرجال و النساء - غرفة رقم 2,شيعي,578,321,6,1,315
صور,صديقين ,حسينية الرجال و النساء - غرفة رقم 3,شيعي,565,316,4,0,312
صور,صديقين ,حسينية الرجال و النساء - غرفة رقم 4,شيعي,543,348,6,1,342
صور,صديقين ,حسينية الرجال و النساء - غرفة رقم 5,شيعي,520,272,0,1,272
صور,صريفا ,المدرسة الرسمية - غرفة رقم 1,شيعي,636,353,9,0,344
صور,صريفا ,المدرسة الرسمية - غرفة رقم 2,شيعي,625,330,6,8,324
صور,صريفا ,المدرسة الرسمية - غرفة رقم 3,شيعي,634,350,8,0,342
صور,صريفا ,المدرسة الرسمية - غرفة رقم 4,شيعي,640,373,3,4,370
صور,صريفا ,المدرسة الرسمية - غرفة رقم 5,شيعي,636,380,3,0,377
صور,صريفا ,المدرسة الرسمية - غرفة رقم 6,شيعي,630,374,1,3,373
صور,صريفا ,المدرسة الرسمية - غرفة رقم 7,شيعي,626,366,5,1,361
صور,صريفا ,المدرسة الرسمية - غرفة رقم 8,شيعي,642,422,4,2,418
صور,صور ,الثانوية الرسمية للبنات - غرفة رقم 6,مختلف,236,41,0,0,41
صور,صور حي الارثوذكس ,بهو كنيسة الروم الارثوذكس - غرفة رقم 1,روم ارثوذكس,474,86,2,2,84
صور,صور حي الجامع ,المدرسة التكميلية الاولى ( احمد جمعه) - غرفة رقم 1,سني,629,216,9,6,207
صور,صور حي الجامع ,المدرسة التكميلية الاولى ( احمد جمعه) - غرفة رقم 2,سني,624,183,9,6,174
صور,صور حي الجامع ,المدرسة التكميلية الاولى ( احمد جمعه) - غرفة رقم 3,سني,583,286,12,7,274
صور,صور حي الجامع ,المدرسة التكميلية الاولى ( احمد جمعه) - غرفة رقم 4,شيعي,593,265,16,7,249
صور,صور حي الجامع ,المدرسة التكميلية الاولى ( احمد جمعه) - غرفة رقم 5,شيعي,566,219,8,3,211
صور,صور حي الجورة ,المدرسة التكميلية الاولى ( احمد جمعه) - غرفة رقم 10,شيعي,592,276,10,4,266
صور,صور حي الجورة ,المدرسة التكميلية الاولى ( احمد جمعه) - غرفة رقم 11,شيعي,584,270,9,3,261
صور,صور حي الجورة ,المدرسة التكميلية الاولى ( احمد جمعه) - غرفة رقم 12,شيعي,646,307,5,0,302
صور,صور حي الجورة ,المدرسة التكميلية الاولى ( احمد جمعه) - غرفة رقم 13,مختلف,641,254,7,1,247
صور,صور حي الجورة ,المدرسة التكميلية الاولى ( احمد جمعه) - غرفة رقم 6,شيعي,587,292,10,8,282
صور,صور حي الجورة ,المدرسة التكميلية الاولى ( احمد جمعه) - غرفة رقم 7,شيعي,581,260,9,4,251
صور,صور حي الجورة ,المدرسة التكميلية الاولى ( احمد جمعه) - غرفة رقم 8,شيعي,595,275,6,6,269
صور,صور حي الجورة ,المدرسة التكميلية الاولى ( احمد جمعه) - غرفة رقم 9,مختلف,534,215,3,1,212
صور,صور حي الحسينية ,الثانوية الجعفرية - غرفة رقم 1,شيعي,609,168,4,2,164
صور,صور حي الحسينية ,الثانوية الجعفرية - غرفة رقم 10,سني,593,180,10,6,170
صور,صور حي الحسينية ,الثانوية الجعفرية - غرفة رقم 2,شيعي,624,279,5,3,274
صور,صور حي الحسينية ,الثانوية الجعفرية - غرفة رقم 3,شيعي,610,231,0,5,231
صور,صور حي الحسينية ,الثانوية الجعفرية - غرفة رقم 4,شيعي,568,204,3,2,201
صور,صور حي الحسينية ,الثانوية الجعفرية - غرفة رقم 5,سني,633,175,12,3,163
صور,صور حي الحسينية ,الثانوية الجعفرية - غرفة رقم 6,شيعي,617,187,5,4,182
صور,صور حي الحسينية ,الثانوية الجعفرية - غرفة رقم 7,شيعي,610,268,5,0,263
صور,صور حي الحسينية ,الثانوية الجعفرية - غرفة رقم 8,شيعي,621,227,13,3,214
صور,صور حي الحسينية ,الثانوية الجعفرية - غرفة رقم 9,شيعي,618,237,3,1,234
صور,صور حي الكاثوليك ,مدرسة راهبات مار يوسف المدخل الجنوبي - غرفة رقم 1,روم كاثوليك,505,81,1,3,80
صور,صور حي الكاثوليك ,مدرسة راهبات مار يوسف المدخل الجنوبي - غرفة رقم 2,روم كاثوليك,527,110,1,1,109
صور,صور حي الكاثوليك ,مدرسة راهبات مار يوسف المدخل الجنوبي - غرفة رقم 3,روم كاثوليك,495,62,1,3,61
صور,صور حي الكاثوليك ,مدرسة راهبات مار يوسف المدخل الجنوبي - غرفة رقم 4,مسيحي,494,43,0,2,43
صور,صور حي الكاثوليك ,مدرسة راهبات مار يوسف المدخل الجنوبي - غرفة رقم 5,روم كاثوليك,554,69,1,4,68
صور,صور حي الكاثوليك ,مدرسة راهبات مار يوسف المدخل الجنوبي - غرفة رقم 6,روم كاثوليك,542,86,4,1,82
صور,صور حي الكاثوليك ,مدرسة راهبات مار يوسف المدخل الجنوبي - غرفة رقم 7,روم كاثوليك,565,79,4,3,75
صور,صور حي الكاثوليك ,مدرسة راهبات مار يوسف المدخل الجنوبي - غرفة رقم 8,مسيحي,530,44,0,1,44
صور,صور حي المصاروي ,المدرسة الجعفرية المهنيه - غرفة رقم 1,شيعي,567,143,2,3,141
صور,صور حي المصاروي ,المدرسة الجعفرية المهنيه - غرفة رقم 2,شيعي,568,152,1,6,151
صور,صور حي المصاروي ,المدرسة الجعفرية المهنيه - غرفة رقم 3,مختلف,580,200,9,2,191
صور,صور حي المصاروي ,المدرسة الجعفرية المهنيه - غرفة رقم 4,شيعي,560,152,5,2,147
صور,صور حي المصاروي ,المدرسة الجعفرية المهنيه - غرفة رقم 5,شيعي,594,171,5,1,166
صور,صور حي المصاروي ,المدرسة الجعفرية المهنيه - غرفة رقم 6,مختلف,563,174,5,0,169
صور,صور حي المنارة ,الجامعة الاسلامية الشواكير - غرفة رقم 1,شيعي,576,256,9,1,247
صور,صور حي المنارة ,الجامعة الاسلامية الشواكير - غرفة رقم 2,شيعي,563,224,9,2,215
صور,صور حي المنارة ,الجامعة الاسلامية الشواكير - غرفة رقم 3,شيعي,569,238,14,6,224
صور,صور حي المنارة ,الجامعة الاسلامية الشواكير - غرفة رقم 4,شيعي,660,286,8,8,278
صور,صور حي المنارة ,الجامعة الاسلامية الشواكير - غرفة رقم 5,شيعي,621,281,16,4,265
صور,صور حي المنارة ,الجامعة الاسلامية الشواكير - غرفة رقم 6,شيعي,593,234,7,0,227
صور,صور حي المنارة ,الجامعة الاسلامية الشواكير - غرفة رقم 7,شيعي,551,214,7,1,207
صور,صور حي المنارة ,الجامعة الاسلامية الشواكير - غرفة رقم 8,مسلم,567,196,4,3,192
صور,صور حي المنارة ,الجامعة الاسلامية الشواكير - غرفة رقم 9,مسلم,580,197,5,5,192
صور,صور حي الموارنة ,مدرسة راهبات مار يوسف المدخل الشمالي - غرفة رقم 1,ماروني,519,66,2,1,64
صور,صور حي الموارنة ,مدرسة راهبات مار يوسف المدخل الشمالي - غرفة رقم 2,ماروني,499,68,3,6,65
صور,صور حي الموارنة ,مدرسة راهبات مار يوسف المدخل الشمالي - غرفة رقم 3,مسيحي,551,48,1,0,47
صور,صور للموظفون ,ثانويه صور الرسميه للبنات - غرفة رقم 1,مختلف,431,380,16,15,364
صور,صور للموظفون ,ثانويه صور الرسميه للبنات - غرفة رقم 2,مختلف,444,395,10,26,385
صور,طورا ,مدرسة طورا الابتدائية الرسمية - غرفة رقم 1,شيعي,608,344,2,6,342
صور,طورا ,مدرسة طورا الابتدائية الرسمية - غرفة رقم 2,شيعي,622,320,7,6,313
صور,طورا ,مدرسة طورا الابتدائية الرسمية - غرفة رقم 3,شيعي,596,335,2,1,333
صور,طورا ,مدرسة طورا الابتدائية الرسمية - غرفة رقم 4,شيعي,582,366,5,6,361
صور,طورا ,مدرسة طورا الابتدائية الرسمية - غرفة رقم 5,شيعي,556,298,7,1,291
صور,طير حرفا ,الثانوية الرسمية - غرفة رقم 1,شيعي,510,295,5,4,290
صور,طير حرفا ,الثانوية الرسمية - غرفة رقم 2,شيعي,486,227,9,1,218
صور,طير حرفا ,الثانوية الرسمية - غرفة رقم 3,شيعي,550,362,4,1,358
صور,طير حرفا ,الثانوية الرسمية - غرفة رقم 4,شيعي,500,302,11,3,291
صور,طير دبا ,مبنى البلدية - غرفة رقم 1,شيعي,587,309,4,3,305
صور,طير دبا ,مبنى البلدية - غرفة رقم 2,شيعي,569,337,6,5,331
صور,طير دبا ,مبنى البلدية - غرفة رقم 3,شيعي,544,308,9,2,299
صور,طير دبا ,مبنى البلدية - غرفة رقم 4,شيعي,565,356,11,3,345
صور,طير دبا ,مبنى البلدية - غرفة رقم 5,شيعي,558,351,1,4,350
صور,طير دبا ,مبنى البلدية - غرفة رقم 6,شيعي,542,329,7,3,322
صور,طير فلسيه ,مدرسة طيرفلسيه المتوسطة الرسمية - غرفة رقم 1,شيعي,597,321,5,1,316
صور,طير فلسيه ,مدرسة طيرفلسيه المتوسطة الرسمية - غرفة رقم 2,شيعي,565,302,2,2,300
صور,طير فلسيه ,مدرسة طيرفلسيه المتوسطة الرسمية - غرفة رقم 3,شيعي,555,319,4,1,315
صور,طير فلسيه ,مدرسة طيرفلسيه المتوسطة الرسمية - غرفة رقم 4,شيعي,540,322,1,0,321
صور,طير فلسيه ,مدرسة طيرفلسيه المتوسطة الرسمية - غرفة رقم 5,شيعي,541,292,5,4,287
صور,عباسية ,الثانوية الرسمية - غرفة رقم 1,شيعي,654,232,6,2,226
صور,عباسية ,الثانوية الرسمية - غرفة رقم 2,شيعي,632,294,9,2,285
صور,عباسية ,الثانوية الرسمية - غرفة رقم 3,شيعي,660,261,4,2,257
صور,عباسية ,الثانوية الرسمية - غرفة رقم 4,شيعي,674,361,6,3,355
صور,عباسية ,الثانوية الرسمية - غرفة رقم 5,شيعي,655,288,2,3,286
صور,عباسية ,الثانوية الرسمية - غرفة رقم 6,شيعي,642,336,2,3,334
صور,عباسية ,الثانوية الرسمية - غرفة رقم 7,شيعي,638,307,0,1,307
صور,عباسية ,الثانوية الرسمية - غرفة رقم 8,شيعي,631,377,3,1,374
صور,علما الشعب ,المدرسة الرسمية - غرفة رقم 1,مسيحي,619,98,3,4,95
صور,علما الشعب ,المدرسة الرسمية - غرفة رقم 2,مسيحي,649,77,6,1,71
صور,علما الشعب ,المدرسة الرسمية - غرفة رقم 3,مسيحي,507,64,2,2,62
صور,علما الشعب ,المدرسة الرسمية - غرفة رقم 4,مسيحي,545,73,1,1,72
صور,عيتيت ,المدرسة الرسمية - غرفة رقم 1,شيعي,618,329,7,4,322
صور,عيتيت ,المدرسة الرسمية - غرفة رقم 2,شيعي,679,328,5,3,323
صور,عيتيت ,المدرسة الرسمية - غرفة رقم 3,شيعي,650,393,7,2,386
صور,عيتيت ,المدرسة الرسمية - غرفة رقم 4,شيعي,704,411,1,1,410
صور,عين بعال ,الثانوية الرسمية - غرفة رقم 1,شيعي,550,202,6,4,196
صور,عين بعال ,الثانوية الرسمية - غرفة رقم 2,شيعي,562,208,0,0,208
صور,عين بعال ,الثانوية الرسمية - غرفة رقم 3,شيعي,588,221,13,2,208
صور,عين بعال ,الثانوية الرسمية - غرفة رقم 4,شيعي,571,255,7,0,248
صور,عين بعال ,الثانوية الرسمية - غرفة رقم 5,شيعي,581,267,5,0,262
صور,عين بعال ,الثانوية الرسمية - غرفة رقم 6,شيعي,575,260,9,2,251
صور,قانا ,الثانوية الرسمية - غرفة رقم 1,شيعي,578,189,0,1,189
صور,قانا ,الثانوية الرسمية - غرفة رقم 10,شيعي,660,270,0,1,270
صور,قانا ,الثانوية الرسمية - غرفة رقم 11,شيعي,645,330,9,3,321
صور,قانا ,الثانوية الرسمية - غرفة رقم 12,شيعي,644,228,6,3,222
صور,قانا ,الثانوية الرسمية - غرفة رقم 13,مختلف,654,149,3,0,146
صور,قانا ,الثانوية الرسمية - غرفة رقم 2,شيعي,571,112,4,0,108
صور,قانا ,الثانوية الرسمية - غرفة رقم 3,شيعي,568,218,3,1,215
صور,قانا ,الثانوية الرسمية - غرفة رقم 4,شيعي,560,174,6,2,168
صور,قانا ,الثانوية الرسمية - غرفة رقم 5,شيعي,587,202,4,2,198
صور,قانا ,الثانوية الرسمية - غرفة رقم 6,شيعي,564,201,0,0,201
صور,قانا ,الثانوية الرسمية - غرفة رقم 7,مختلف,526,72,0,0,72
صور,قانا ,الثانوية الرسمية - غرفة رقم 8,شيعي,646,258,2,1,256
صور,قانا ,الثانوية الرسمية - غرفة رقم 9,شيعي,629,170,0,0,170
صور,قليله ,المدرسة الرسمية - غرفة رقم 1,مسلم,562,248,2,3,246
صور,قليله ,المدرسة الرسمية - غرفة رقم 2,شيعي,571,278,2,3,276
صور,قليله ,المدرسة الرسمية - غرفة رقم 3,شيعي,553,268,3,0,265
صور,قليله ,المدرسة الرسمية - غرفة رقم 4,مسلم,559,300,1,1,299
صور,قليله ,المدرسة الرسمية - غرفة رقم 5,شيعي,559,335,1,3,334
صور,قليله ,المدرسة الرسمية - غرفة رقم 6,شيعي,574,312,2,5,310
صور,مجادل ,المدرسة الرسمية - غرفة رقم 1,شيعي,652,410,1,2,409
صور,مجادل ,المدرسة الرسمية - غرفة رقم 2,شيعي,670,355,4,1,351
صور,مجادل ,المدرسة الرسمية - غرفة رقم 3,شيعي,646,425,0,0,425
صور,مجادل ,المدرسة الرسمية - غرفة رقم 4,شيعي,698,382,7,1,375
صور,مجدلزون ,المدرسة الرسمية - غرفة رقم 1,شيعي,556,291,0,2,291
صور,مجدلزون ,المدرسة الرسمية - غرفة رقم 2,شيعي,559,290,5,1,285
صور,مجدلزون ,المدرسة الرسمية - غرفة رقم 3,شيعي,564,360,1,0,359
صور,مجدلزون ,المدرسة الرسمية - غرفة رقم 4,شيعي,578,359,0,0,359
صور,مجدلزون ,المدرسة الرسمية - غرفة رقم 5,شيعي,563,367,8,1,359
صور,محرونه ,حسينية الرجال - غرفة رقم 1,شيعي,598,364,2,0,362
صور,محرونه ,حسينية الرجال - غرفة رقم 2,شيعي,653,390,8,3,382
صور,مروحين ,المدرسة الرسمية - غرفة رقم 1,سني,656,211,7,8,204
صور,مروحين ,المدرسة الرسمية - غرفة رقم 2,سني,677,254,26,10,228
صور,مزرعة مشرف ,حسينية الرجال - غرفة رقم 1,شيعي,524,221,2,1,219
صور,مزرعة مشرف ,حسينية النساء - غرفة رقم 1,شيعي,564,249,1,2,248
صور,معركه ,المدرسة الابتدائية - غرفة رقم 1,شيعي,586,309,14,5,295
صور,معركه ,المدرسة الابتدائية - غرفة رقم 2,شيعي,584,274,4,3,270
صور,معركه ,المدرسة الابتدائية - غرفة رقم 3,شيعي,567,242,4,2,238
صور,معركه ,المدرسة الابتدائية - غرفة رقم 4,شيعي,630,294,7,1,287
صور,معركه ,المدرسة الابتدائية - غرفة رقم 5,شيعي,603,263,4,5,259
صور,معركه ,ثانوية خليل جرادي الرسمية - غرفة رقم 1,شيعي,579,358,6,6,352
صور,معركه ,ثانوية خليل جرادي الرسمية - غرفة رقم 2,شيعي,625,337,7,2,330
صور,معركه ,ثانوية خليل جرادي الرسمية - غرفة رقم 3,شيعي,620,323,9,5,314
صور,معركه ,ثانوية خليل جرادي الرسمية - غرفة رقم 4,شيعي,578,317,5,1,312
صور,معركه ,ثانوية خليل جرادي الرسمية - غرفة رقم 5,شيعي,572,298,1,4,297
صور,معركه ,ثانوية خليل جرادي الرسمية - غرفة رقم 6,شيعي,588,248,4,6,244
صور,معروب ,المدرسة الرسمية - غرفة رقم 1,شيعي,706,409,6,0,403
صور,معروب ,المدرسة الرسمية - غرفة رقم 2,شيعي,679,354,12,1,342
صور,معروب ,المدرسة الرسمية - غرفة رقم 3,شيعي,662,373,0,0,373
صور,معروب ,المدرسة الرسمية - غرفة رقم 4,شيعي,644,329,3,2,326
صور,نفاخيه ,النادي الحسيني في البلدة - غرفة رقم 1,مختلف,252,67,0,0,67
صور,وادي جيلو ,المدرسة الرسمية - غرفة رقم 1,شيعي,698,489,2,14,487
صور,يارين ,المدرسة الرسمية - غرفة رقم 1,سني,645,216,9,5,207
صور,يارين ,المدرسة الرسمية - غرفة رقم 2,سني,557,199,12,2,187
صور,يارين ,المدرسة الرسمية - غرفة رقم 3,سني,662,241,6,6,235
صور,يارين ,المدرسة الرسمية - غرفة رقم 4,سني,630,253,15,3,238
صور,يانوح ,المدرسة الرسمية - غرفة رقم 1,شيعي,558,305,1,4,304
صور,يانوح ,المدرسة الرسمية - غرفة رقم 2,شيعي,515,335,3,2,332
صيدا,حي الدكرمان,المدرسة المهنية صيدا - غرفة رقم 1,سني,622,377,17,4,360
صيدا,حي الدكرمان,المدرسة المهنية صيدا - غرفة رقم 2,سني,644,421,4,5,417
صيدا,حي الدكرمان,المدرسة المهنية صيدا - غرفة رقم 3,سني,626,358,6,9,352
صيدا,حي الدكرمان,المدرسة المهنية صيدا - غرفة رقم 4,سني,652,403,20,10,383
صيدا,حي الدكرمان,المدرسة المهنية صيدا - غرفة رقم 5,سني,638,301,15,2,286
صيدا,حي الدكرمان,المدرسة المهنية صيدا - غرفة رقم 6,مختلف,668,297,10,5,287
صيدا,حي الدكرمان,المدرسة المهنية صيدا - غرفة رقم 7,مختلف,646,277,10,3,267
صيدا,حي الدكرمان,مدرسة عائشة الجديدة - غرفة رقم 1,مختلف,619,289,2,2,287
صيدا,حي الدكرمان,مدرسة عائشة الجديدة - غرفة رقم 2,سني,654,353,12,10,341
صيدا,حي الدكرمان,مدرسة عائشة الجديدة - غرفة رقم 3,سني,606,368,8,21,360
صيدا,حي الدكرمان,مدرسة عائشة الجديدة - غرفة رقم 4,سني,669,417,10,4,407
صيدا,حي الدكرمان,مدرسة عائشة الجديدة - غرفة رقم 5,سني,672,385,11,8,374
صيدا,حي الدكرمان,مدرسة عائشة الجديدة - غرفة رقم 6,سني,615,320,11,4,309
صيدا,حي الدكرمان,مدرسة عائشة الجديدة - غرفة رقم 7,سني,645,259,20,4,239
صيدا,حي الزويتيني ,مدرسة الاصلاح الرسمية للبنات قرب معصرة عبود - غرفة رقم 1,سني,603,354,11,4,343
صيدا,حي الزويتيني ,مدرسة الاصلاح الرسمية للبنات قرب معصرة عبود - غرفة رقم 2,سني,601,349,6,3,343
صيدا,حي الزويتيني ,مدرسة الاصلاح الرسمية للبنات قرب معصرة عبود - غرفة رقم 3,سني,600,359,5,6,354
صيدا,حي الزويتيني ,مدرسة الاصلاح الرسمية للبنات قرب معصرة عبود - غرفة رقم 4,سني,575,337,15,6,322
صيدا,حي الزويتيني ,مدرسة الاصلاح الرسمية للبنات قرب معصرة عبود - غرفة رقم 5,سني,566,301,14,4,287
صيدا,حي السبيل,مدرسة الاصلاح المختلطة الرسمية - غرفة رقم 1,سني,678,391,16,7,375
صيدا,حي السبيل,مدرسة الاصلاح المختلطة الرسمية - غرفة رقم 2,سني,660,407,10,6,397
صيدا,حي السبيل,مدرسة الاصلاح المختلطة الرسمية - غرفة رقم 3,سني,637,391,16,6,375
صيدا,حي السبيل,مدرسة الاصلاح المختلطة الرسمية - غرفة رقم 4,سني,667,418,7,7,411
صيدا,حي السبيل,مدرسة الاصلاح المختلطة الرسمية - غرفة رقم 5,سني,662,388,8,7,380
صيدا,حي السبيل,مدرسة الاصلاح المختلطة الرسمية - غرفة رقم 6,سني,669,376,14,7,362
صيدا,حي السبيل,مدرسة الاصلاح المختلطة الرسمية - غرفة رقم 7,سني,669,388,15,8,373
صيدا,حي السبيل,مدرسة الاصلاح المختلطة الرسمية - غرفة رقم 8,سني,670,349,32,7,317
صيدا,حي السراي,مدرسة اجيال صيدا - غرفة رقم 1,سني,591,341,7,7,334
صيدا,حي السراي,مدرسة اجيال صيدا - غرفة رقم 2,سني,568,349,6,8,343
صيدا,حي السراي,مدرسة اجيال صيدا - غرفة رقم 3,مختلف,569,210,3,5,207
صيدا,حي الشارع,مدرسة الايمان /م شرقى - غرفة رقم 1,سني,672,413,19,10,394
صيدا,حي الشارع,مدرسة الايمان /م شرقى - غرفة رقم 2,سني,634,347,9,7,338
صيدا,حي الشارع,مدرسة الايمان /م شرقى - غرفة رقم 3,سني,508,358,4,2,354
صيدا,حي الشارع,مدرسة الايمان /م شرقى - غرفة رقم 4,سني,623,283,6,4,277
صيدا,حي الشارع,مدرسة الايمان /م شرقى - غرفة رقم 5,مختلف,611,280,17,1,263
صيدا,حي الشارع,مدرسة الايمان /م شرقى - غرفة رقم 6,مختلف,618,163,9,0,154
صيدا,حي الشارع,مدرسة الايمان/م غربي - غرفة رقم,سني,657,403,7,3,396
صيدا,حي الشارع,مدرسة الايمان/م غربي - غرفة رقم 2,سني,643,388,15,14,373
صيدا,حي الشارع,مدرسة الايمان/م غربي - غرفة رقم 3,سني,650,354,11,4,343
صيدا,حي القناية ,المدرسة المتوسطة للصبيان - غرفة رقم 1,مسيحي,563,222,3,1,219
صيدا,حي القناية ,المدرسة المتوسطة للصبيان - غرفة رقم 2,مسيحي,633,265,6,2,259
صيدا,حي الكشك,المدرسة الكويتية الرسمية - غرفة رقم 1,سني,660,388,10,7,378
صيدا,حي الكشك,المدرسة الكويتية الرسمية - غرفة رقم 2,سني,671,388,10,4,378
صيدا,حي الكشك,المدرسة الكويتية الرسمية - غرفة رقم 3,سني,675,441,11,8,430
صيدا,حي الكشك,المدرسة الكويتية الرسمية - غرفة رقم 4,سني,654,380,6,10,374
صيدا,حي الكشك,المدرسة الكويتية الرسمية - غرفة رقم 5,سني,679,401,13,11,388
صيدا,حي الكشك,المدرسة الكويتية الرسمية - غرفة رقم 6,سني,674,439,14,9,425
صيدا,حي الكشك,المدرسة الكويتية الرسمية - غرفة رقم 7,سني,663,346,21,8,325
صيدا,حي الكشك,المدرسة الكويتية الرسمية - غرفة رقم 8,سني,670,356,13,6,343
صيدا,حي الكنان,ثانوية البزري الرسمية - غرفة رقم 1,سني,645,399,15,10,384
صيدا,حي الكنان,ثانوية البزري الرسمية - غرفة رقم 10,سني,663,399,9,4,390
صيدا,حي الكنان,ثانوية البزري الرسمية - غرفة رقم 11,مسلم,588,316,5,4,311
صيدا,حي الكنان,ثانوية البزري الرسمية - غرفة رقم 2,سني,630,427,16,7,411
صيدا,حي الكنان,ثانوية البزري الرسمية - غرفة رقم 3,سني,634,392,8,4,384
صيدا,حي الكنان,ثانوية البزري الرسمية - غرفة رقم 4,سني,626,407,10,10,397
صيدا,حي الكنان,ثانوية البزري الرسمية - غرفة رقم 5,سني,584,303,16,6,287
صيدا,حي الكنان,ثانوية البزري الرسمية - غرفة رقم 6,سني,616,362,9,7,353
صيدا,حي الكنان,ثانوية البزري الرسمية - غرفة رقم 7,سني,608,390,4,7,386
صيدا,حي الكنان,ثانوية البزري الرسمية - غرفة رقم 8,سني,602,380,11,4,369
صيدا,حي الكنان,ثانوية البزري الرسمية - غرفة رقم 9,سني,588,354,7,12,347
صيدا,حي المسالخية,تكميلية البنات الاولى - غرفة رقم 1,سني,665,430,16,8,415
صيدا,حي المسالخية,تكميلية البنات الاولى - غرفة رقم 2,سني,653,371,11,9,360
صيدا,حي المسالخية,تكميلية البنات الاولى - غرفة رقم 3,سني,673,386,18,3,368
صيدا,حي المسالخية,تكميلية البنات الاولى - غرفة رقم 4,سني,650,335,8,3,327
صيدا,حي المسالخية,تكميلية البنات الاولى - غرفة رقم 5,سني,628,271,5,4,266
صيدا,حي الوسطاني,ثانوية البنات الثانية مرجان - غرفة رقم 1,سني,661,406,12,5,394
صيدا,حي الوسطاني,ثانوية البنات الثانية مرجان - غرفة رقم 2,سني,607,340,15,8,325
صيدا,حي الوسطاني,ثانوية البنات الثانية مرجان - غرفة رقم 3,سني,636,385,14,3,371
صيدا,حي الوسطاني,ثانوية البنات الثانية مرجان - غرفة رقم 4,سني,618,364,11,5,353
صيدا,حي الوسطاني,ثانوية البنات الثانية مرجان - غرفة رقم 5,سني,681,386,23,8,363
صيدا,حي الوسطاني,متوسطة الشهيد معروف سعد - غرفة رقم 1,سني,631,368,33,3,335
صيدا,حي الوسطاني,متوسطة الشهيد معروف سعد - غرفة رقم 2,سني,609,292,6,5,286
صيدا,حي الوسطاني,متوسطة الشهيد معروف سعد - غرفة رقم 3,سني,618,389,12,3,377
صيدا,حي الوسطاني,متوسطة الشهيد معروف سعد - غرفة رقم 4,سني,628,387,21,7,366
صيدا,حي الوسطاني,متوسطة الشهيد معروف سعد - غرفة رقم 5,سني,612,346,3,8,343
صيدا,حي الوسطاني,متوسطة الشهيد معروف سعد - غرفة رقم 6,سني,668,355,30,15,325
صيدا,حي الوسطاني,متوسطة الشهيد معروف سعد - غرفة رقم 7,مختلف,626,229,24,8,205
صيدا,حي رجال الأربعين,المدرسة الانجيلية الامركان - غرفة رقم 1,سني,654,445,12,5,433
صيدا,حي رجال الأربعين,المدرسة الانجيلية الامركان - غرفة رقم 10,شيعي,643,327,4,4,323
صيدا,حي رجال الأربعين,المدرسة الانجيلية الامركان - غرفة رقم 11,شيعي,612,295,3,3,292
صيدا,حي رجال الأربعين,المدرسة الانجيلية الامركان - غرفة رقم 2,سني,659,406,28,5,378
صيدا,حي رجال الأربعين,المدرسة الانجيلية الامركان - غرفة رقم 3,سني,641,391,9,3,382
صيدا,حي رجال الأربعين,المدرسة الانجيلية الامركان - غرفة رقم 4,سني,638,422,9,8,413
صيدا,حي رجال الأربعين,المدرسة الانجيلية الامركان - غرفة رقم 5,سني,645,325,16,7,309
صيدا,حي رجال الأربعين,المدرسة الانجيلية الامركان - غرفة رقم 6,شيعي,669,383,4,2,379
صيدا,حي رجال الأربعين,المدرسة الانجيلية الامركان - غرفة رقم 7,شيعي,639,314,1,2,313
صيدا,حي رجال الأربعين,المدرسة الانجيلية الامركان - غرفة رقم 8,شيعي,655,334,11,8,323
صيدا,حي رجال الأربعين,المدرسة الانجيلية الامركان - غرفة رقم 9,شيعي,657,389,6,5,383
صيدا,حي مار نقولا,بلدية صيدا - غرفة رقم 1,مختلف,444,226,9,2,217
صيدا,حي مار نقولا,بلدية صيدا - غرفة رقم 2,مختلف,513,287,3,9,284
صيدا,حي مار نقولا,بلدية صيدا - غرفة رقم 3,مسيحي,463,84,2,0,82
صيدا,حي مار نقولا,بلدية صيدا - غرفة رقم 4,مسيحي,467,71,1,2,70
صيدا,حي مكسر العبد,جامعة AUST - غرفة رقم 1,سني,473,404,9,6,395
صيدا,حي مكسر العبد,جامعة AUST - غرفة رقم 2,سني,544,319,3,3,316
صيدا,حي مكسر العبد,جامعة AUST - غرفة رقم 3,سني,571,418,4,4,414
صيدا,حي مكسر العبد,جامعة AUST - غرفة رقم 4,سني,555,361,8,8,353
صيدا,دول إقليمية,دول إقليمية,مختلف,722,449,6,10,443
صيدا,صيدا موظفون ,سراى صيدا - غرفة رقم 1,مختلف,107,95,1,5,94
طرابلس,البداوي ,المدرسة الرسمية للصبيان - غرفة رقم 1,سني,626,301,11,2,290
طرابلس,البداوي ,المدرسة الرسمية للصبيان - غرفة رقم 2,سني,616,221,5,5,216
طرابلس,البداوي ,المدرسة الرسمية للصبيان - غرفة رقم 3,سني,600,285,6,8,279
طرابلس,البداوي ,المدرسة الرسمية للصبيان - غرفة رقم 4,سني,627,255,9,10,246
طرابلس,البداوي ,المدرسة الرسمية للصبيان - غرفة رقم 5,سني,660,352,17,4,335
طرابلس,البداوي ,المدرسة الرسمية للصبيان - غرفة رقم 6,سني,649,373,28,7,345
طرابلس,البداوي ,متوسطة البداوي للبنات - غرفة رقم 1,سني,636,298,5,4,293
طرابلس,البداوي ,متوسطة البداوي للبنات - غرفة رقم 2,سني,626,222,12,4,210
طرابلس,البداوي ,متوسطة البداوي للبنات - غرفة رقم 3,سني,621,293,20,7,273
طرابلس,البداوي ,متوسطة البداوي للبنات - غرفة رقم 4,سني,592,247,14,6,233
طرابلس,البداوي ,متوسطة البداوي للبنات - غرفة رقم 5,سني,610,279,9,8,270
طرابلس,البداوي ,متوسطة البداوي للبنات - غرفة رقم 6,سني,684,283,23,7,260
طرابلس,التبانة ,ثانوية طرابلس الرسمية للبنات - غرفة رقم 1,سني,651,370,23,5,347
طرابلس,التبانة ,ثانوية طرابلس الرسمية للبنات - غرفة رقم 10,سني,631,252,8,7,244
طرابلس,التبانة ,ثانوية طرابلس الرسمية للبنات - غرفة رقم 11,سني,628,214,4,7,210
طرابلس,التبانة ,ثانوية طرابلس الرسمية للبنات - غرفة رقم 12,سني,630,248,10,4,238
طرابلس,التبانة ,ثانوية طرابلس الرسمية للبنات - غرفة رقم 13,سني,631,249,5,6,244
طرابلس,التبانة ,ثانوية طرابلس الرسمية للبنات - غرفة رقم 14,سني,616,227,17,3,210
طرابلس,التبانة ,ثانوية طرابلس الرسمية للبنات - غرفة رقم 15,سني,629,282,11,5,271
طرابلس,التبانة ,ثانوية طرابلس الرسمية للبنات - غرفة رقم 16,سني,645,240,4,8,236
طرابلس,التبانة ,ثانوية طرابلس الرسمية للبنات - غرفة رقم 2,سني,626,223,2,1,221
طرابلس,التبانة ,ثانوية طرابلس الرسمية للبنات - غرفة رقم 3,سني,643,259,9,1,250
طرابلس,التبانة ,ثانوية طرابلس الرسمية للبنات - غرفة رقم 4,سني,657,253,12,1,241
طرابلس,التبانة ,ثانوية طرابلس الرسمية للبنات - غرفة رقم 5,سني,633,265,10,2,255
طرابلس,التبانة ,ثانوية طرابلس الرسمية للبنات - غرفة رقم 6,سني,666,257,26,3,231
طرابلس,التبانة ,ثانوية طرابلس الرسمية للبنات - غرفة رقم 7,سني,634,274,21,6,253
طرابلس,التبانة ,ثانوية طرابلس الرسمية للبنات - غرفة رقم 8,سني,655,248,11,7,237
طرابلس,التبانة ,ثانوية طرابلس الرسمية للبنات - غرفة رقم 9,سني,636,237,6,6,231
طرابلس,التبانة ,متوسطة التبانة الرسمية – بولفار التبانة - غرفة رقم 1,سني,623,232,5,6,227
طرابلس,التبانة ,متوسطة التبانة الرسمية – بولفار التبانة - غرفة رقم 10,سني,676,250,15,9,235
طرابلس,التبانة ,متوسطة التبانة الرسمية – بولفار التبانة - غرفة رقم 11,سني,629,247,7,4,240
طرابلس,التبانة ,متوسطة التبانة الرسمية – بولفار التبانة - غرفة رقم 12,سني,639,254,4,2,250
طرابلس,التبانة ,متوسطة التبانة الرسمية – بولفار التبانة - غرفة رقم 13,سني,635,208,6,4,202
طرابلس,التبانة ,متوسطة التبانة الرسمية – بولفار التبانة - غرفة رقم 14,سني,656,288,10,2,278
طرابلس,التبانة ,متوسطة التبانة الرسمية – بولفار التبانة - غرفة رقم 15,سني,659,289,25,7,264
طرابلس,التبانة ,متوسطة التبانة الرسمية – بولفار التبانة - غرفة رقم 16,سني,680,333,19,11,314
طرابلس,التبانة ,متوسطة التبانة الرسمية – بولفار التبانة - غرفة رقم 2,سني,654,261,3,3,258
طرابلس,التبانة ,متوسطة التبانة الرسمية – بولفار التبانة - غرفة رقم 3,سني,614,241,7,5,234
طرابلس,التبانة ,متوسطة التبانة الرسمية – بولفار التبانة - غرفة رقم 4,سني,670,243,13,1,230
طرابلس,التبانة ,متوسطة التبانة الرسمية – بولفار التبانة - غرفة رقم 5,سني,625,215,17,1,198
طرابلس,التبانة ,متوسطة التبانة الرسمية – بولفار التبانة - غرفة رقم 6,سني,634,232,4,4,228
طرابلس,التبانة ,متوسطة التبانة الرسمية – بولفار التبانة - غرفة رقم 7,سني,650,238,8,3,230
طرابلس,التبانة ,متوسطة التبانة الرسمية – بولفار التبانة - غرفة رقم 8,سني,638,274,11,5,263
طرابلس,التبانة ,متوسطة التبانة الرسمية – بولفار التبانة - غرفة رقم 9,سني,651,227,33,9,194
طرابلس,التبانة ,مدرسة ابي فراس الحمداني - غرفة رقم 1,علوي,609,189,5,1,184
طرابلس,التبانة ,مدرسة ابي فراس الحمداني - غرفة رقم 10,علوي,610,204,8,0,196
طرابلس,التبانة ,مدرسة ابي فراس الحمداني - غرفة رقم 11,علوي,638,302,3,1,299
طرابلس,التبانة ,مدرسة ابي فراس الحمداني - غرفة رقم 12,علوي,604,260,7,2,253
طرابلس,التبانة ,مدرسة ابي فراس الحمداني - غرفة رقم 13,مختلف,598,200,2,9,198
طرابلس,التبانة ,مدرسة ابي فراس الحمداني - غرفة رقم 14,مختلف,422,96,2,5,94
طرابلس,التبانة ,مدرسة ابي فراس الحمداني - غرفة رقم 2,علوي,611,178,23,2,155
طرابلس,التبانة ,مدرسة ابي فراس الحمداني - غرفة رقم 3,علوي,606,157,4,0,153
طرابلس,التبانة ,مدرسة ابي فراس الحمداني - غرفة رقم 4,علوي,602,210,9,2,201
طرابلس,التبانة ,مدرسة ابي فراس الحمداني - غرفة رقم 5,علوي,606,144,7,2,137
طرابلس,التبانة ,مدرسة ابي فراس الحمداني - غرفة رقم 6,علوي,615,196,9,1,187
طرابلس,التبانة ,مدرسة ابي فراس الحمداني - غرفة رقم 7,علوي,609,149,4,0,145
طرابلس,التبانة ,مدرسة ابي فراس الحمداني - غرفة رقم 8,علوي,618,158,5,1,153
طرابلس,التبانة ,مدرسة ابي فراس الحمداني - غرفة رقم 9,علوي,622,210,5,1,205
طرابلس,التبانة ,مدرسة الزهرية الرسمية للصبيان - غرفة رقم 1,سني,652,248,19,6,229
طرابلس,التبانة ,مدرسة الزهرية الرسمية للصبيان - غرفة رقم 10,سني,635,297,12,4,285
طرابلس,التبانة ,مدرسة الزهرية الرسمية للصبيان - غرفة رقم 11,سني,650,252,10,5,242
طرابلس,التبانة ,مدرسة الزهرية الرسمية للصبيان - غرفة رقم 12,سني,675,325,10,2,315
طرابلس,التبانة ,مدرسة الزهرية الرسمية للصبيان - غرفة رقم 13,سني,632,278,8,4,270
طرابلس,التبانة ,مدرسة الزهرية الرسمية للصبيان - غرفة رقم 14,سني,646,255,10,8,245
طرابلس,التبانة ,مدرسة الزهرية الرسمية للصبيان - غرفة رقم 15,سني,652,288,8,6,280
طرابلس,التبانة ,مدرسة الزهرية الرسمية للصبيان - غرفة رقم 16,سني,652,246,9,3,237
طرابلس,التبانة ,مدرسة الزهرية الرسمية للصبيان - غرفة رقم 2,سني,657,259,11,2,248
طرابلس,التبانة ,مدرسة الزهرية الرسمية للصبيان - غرفة رقم 3,سني,661,259,14,5,245
طرابلس,التبانة ,مدرسة الزهرية الرسمية للصبيان - غرفة رقم 4,سني,660,304,8,4,296
طرابلس,التبانة ,مدرسة الزهرية الرسمية للصبيان - غرفة رقم 5,سني,653,268,12,6,256
طرابلس,التبانة ,مدرسة الزهرية الرسمية للصبيان - غرفة رقم 6,سني,657,287,9,9,278
طرابلس,التبانة ,مدرسة الزهرية الرسمية للصبيان - غرفة رقم 7,سني,670,272,10,8,262
طرابلس,التبانة ,مدرسة الزهرية الرسمية للصبيان - غرفة رقم 8,سني,668,269,6,5,263
طرابلس,التبانة ,مدرسة الزهرية الرسمية للصبيان - غرفة رقم 9,سني,676,284,13,13,271
طرابلس,التبانة ,مدرسة جبران خليل جبران الرسمية للبنات - غرفة رقم 1,سني,651,228,10,3,218
طرابلس,التبانة ,مدرسة جبران خليل جبران الرسمية للبنات - غرفة رقم 10,سني,666,307,16,5,291
طرابلس,التبانة ,مدرسة جبران خليل جبران الرسمية للبنات - غرفة رقم 11,سني,661,330,24,8,306
طرابلس,التبانة ,مدرسة جبران خليل جبران الرسمية للبنات - غرفة رقم 2,سني,655,248,8,7,240
طرابلس,التبانة ,مدرسة جبران خليل جبران الرسمية للبنات - غرفة رقم 3,سني,679,272,10,5,262
طرابلس,التبانة ,مدرسة جبران خليل جبران الرسمية للبنات - غرفة رقم 4,سني,683,293,13,6,280
طرابلس,التبانة ,مدرسة جبران خليل جبران الرسمية للبنات - غرفة رقم 5,سني,683,242,10,4,232
طرابلس,التبانة ,مدرسة جبران خليل جبران الرسمية للبنات - غرفة رقم 6,سني,685,287,14,5,273
طرابلس,التبانة ,مدرسة جبران خليل جبران الرسمية للبنات - غرفة رقم 7,سني,652,291,19,2,272
طرابلس,التبانة ,مدرسة جبران خليل جبران الرسمية للبنات - غرفة رقم 8,سني,663,276,8,4,268
طرابلس,التبانة ,مدرسة جبران خليل جبران الرسمية للبنات - غرفة رقم 9,سني,673,229,6,2,223
طرابلس,التبانة ,مدرسة لقمان الرسمية المختلطة - غرفة رقم 1,علوي,617,178,5,0,173
طرابلس,التبانة ,مدرسة لقمان الرسمية المختلطة - غرفة رقم 10,علوي,613,182,0,2,182
طرابلس,التبانة ,مدرسة لقمان الرسمية المختلطة - غرفة رقم 11,علوي,612,196,0,0,196
طرابلس,التبانة ,مدرسة لقمان الرسمية المختلطة - غرفة رقم 12,علوي,627,207,7,3,200
طرابلس,التبانة ,مدرسة لقمان الرسمية المختلطة - غرفة رقم 13,علوي,628,297,2,3,295
طرابلس,التبانة ,مدرسة لقمان الرسمية المختلطة - غرفة رقم 14,علوي,639,272,5,1,267
طرابلس,التبانة ,مدرسة لقمان الرسمية المختلطة - غرفة رقم 2,علوي,606,174,6,1,168
طرابلس,التبانة ,مدرسة لقمان الرسمية المختلطة - غرفة رقم 3,علوي,594,154,16,0,138
طرابلس,التبانة ,مدرسة لقمان الرسمية المختلطة - غرفة رقم 4,علوي,590,133,9,1,124
طرابلس,التبانة ,مدرسة لقمان الرسمية المختلطة - غرفة رقم 5,علوي,618,200,4,2,196
طرابلس,التبانة ,مدرسة لقمان الرسمية المختلطة - غرفة رقم 6,علوي,606,137,10,0,127
طرابلس,التبانة ,مدرسة لقمان الرسمية المختلطة - غرفة رقم 7,علوي,606,215,4,0,211
طرابلس,التبانة ,مدرسة لقمان الرسمية المختلطة - غرفة رقم 8,علوي,613,141,7,8,134
طرابلس,التبانة ,مدرسة لقمان الرسمية المختلطة - غرفة رقم 9,علوي,600,150,7,3,143
طرابلس,التل ,المدرسة الجديدة الرسمية للبنات - غرفة رقم 1,سني,602,237,5,5,232
طرابلس,التل ,المدرسة الجديدة الرسمية للبنات - غرفة رقم 2,مختلف,590,185,2,2,183
طرابلس,التل ,المدرسة الجديدة الرسمية للبنات - غرفة رقم 3,مسيحي,538,87,3,1,84
طرابلس,التل ,المدرسة الجديدة الرسمية للبنات - غرفة رقم 4,ماروني,492,120,11,2,109
طرابلس,التل ,المدرسة الجديدة الرسمية للبنات - غرفة رقم 5,روم ارثوذكس,546,125,0,1,125
طرابلس,التل ,ثانوية المربي حسن الحجة الرسمية - غرفة رقم 1,سني,615,265,4,5,261
طرابلس,التل ,ثانوية المربي حسن الحجة الرسمية - غرفة رقم 2,سني,607,244,7,8,237
طرابلس,التل ,ثانوية المربي حسن الحجة الرسمية - غرفة رقم 3,سني,595,201,10,0,191
طرابلس,التل ,ثانوية المربي حسن الحجة الرسمية - غرفة رقم 4,سني,603,245,8,2,237
طرابلس,التل ,ثانوية المربي حسن الحجة الرسمية - غرفة رقم 5,سني,574,228,4,6,224
طرابلس,التل ,ثانوية المربي حسن الحجة الرسمية - غرفة رقم 6,سني,588,237,5,3,232
طرابلس,التل ,ثانوية المربي حسن الحجة الرسمية - غرفة رقم 7,سني,573,224,3,5,221
طرابلس,الحدادين ,ثانوية المربى مواهب اسطى الرسمية للبنين - غرفة رقم 1,سني,648,255,6,4,249
طرابلس,الحدادين ,ثانوية المربى مواهب اسطى الرسمية للبنين - غرفة رقم 10,سني,639,243,4,3,239
طرابلس,الحدادين ,ثانوية المربى مواهب اسطى الرسمية للبنين - غرفة رقم 11,سني,657,254,6,6,248
طرابلس,الحدادين ,ثانوية المربى مواهب اسطى الرسمية للبنين - غرفة رقم 2,سني,630,240,5,3,235
طرابلس,الحدادين ,ثانوية المربى مواهب اسطى الرسمية للبنين - غرفة رقم 3,سني,638,280,11,5,269
طرابلس,الحدادين ,ثانوية المربى مواهب اسطى الرسمية للبنين - غرفة رقم 4,سني,654,233,10,7,223
طرابلس,الحدادين ,ثانوية المربى مواهب اسطى الرسمية للبنين - غرفة رقم 5,سني,651,248,12,2,236
طرابلس,الحدادين ,ثانوية المربى مواهب اسطى الرسمية للبنين - غرفة رقم 6,سني,645,266,17,5,249
طرابلس,الحدادين ,ثانوية المربى مواهب اسطى الرسمية للبنين - غرفة رقم 7,سني,639,251,10,8,241
طرابلس,الحدادين ,ثانوية المربى مواهب اسطى الرسمية للبنين - غرفة رقم 8,سني,632,285,9,13,276
طرابلس,الحدادين ,ثانوية المربى مواهب اسطى الرسمية للبنين - غرفة رقم 9,سني,642,255,4,4,251
طرابلس,الحدادين ,دار التربية والتعليم الاسلامية - غرفة رقم 1,سني,629,225,11,3,214
طرابلس,الحدادين ,دار التربية والتعليم الاسلامية - غرفة رقم 10,سني,646,306,30,7,276
طرابلس,الحدادين ,دار التربية والتعليم الاسلامية - غرفة رقم 11,سني,615,261,11,6,250
طرابلس,الحدادين ,دار التربية والتعليم الاسلامية - غرفة رقم 12,سني,660,407,13,6,394
طرابلس,الحدادين ,دار التربية والتعليم الاسلامية - غرفة رقم 13,سني,651,361,19,8,342
طرابلس,الحدادين ,دار التربية والتعليم الاسلامية - غرفة رقم 14,سني,638,297,17,10,280
طرابلس,الحدادين ,دار التربية والتعليم الاسلامية - غرفة رقم 15,سني,623,278,33,4,245
طرابلس,الحدادين ,دار التربية والتعليم الاسلامية - غرفة رقم 16,سني,632,235,4,1,231
طرابلس,الحدادين ,دار التربية والتعليم الاسلامية - غرفة رقم 2,سني,633,253,22,5,231
طرابلس,الحدادين ,دار التربية والتعليم الاسلامية - غرفة رقم 3,سني,613,251,18,2,233
طرابلس,الحدادين ,دار التربية والتعليم الاسلامية - غرفة رقم 4,سني,624,262,14,5,248
طرابلس,الحدادين ,دار التربية والتعليم الاسلامية - غرفة رقم 5,سني,649,261,8,11,253
طرابلس,الحدادين ,دار التربية والتعليم الاسلامية - غرفة رقم 6,سني,631,263,8,6,255
طرابلس,الحدادين ,دار التربية والتعليم الاسلامية - غرفة رقم 7,سني,636,239,6,4,233
طرابلس,الحدادين ,دار التربية والتعليم الاسلامية - غرفة رقم 8,سني,622,226,9,4,217
طرابلس,الحدادين ,دار التربية والتعليم الاسلامية - غرفة رقم 9,سني,621,252,10,8,242
طرابلس,الحدادين ,مدرسة الفضيلة للصبيان - غرفة رقم 1,سني,616,254,3,5,251
طرابلس,الحدادين ,مدرسة الفضيلة للصبيان - غرفة رقم 10,سني,611,210,4,3,206
طرابلس,الحدادين ,مدرسة الفضيلة للصبيان - غرفة رقم 11,سني,629,243,5,1,238
طرابلس,الحدادين ,مدرسة الفضيلة للصبيان - غرفة رقم 12,سني,622,205,10,3,195
طرابلس,الحدادين ,مدرسة الفضيلة للصبيان - غرفة رقم 13,سني,606,237,6,1,231
طرابلس,الحدادين ,مدرسة الفضيلة للصبيان - غرفة رقم 2,سني,614,254,14,4,240
طرابلس,الحدادين ,مدرسة الفضيلة للصبيان - غرفة رقم 3,سني,612,272,8,4,264
طرابلس,الحدادين ,مدرسة الفضيلة للصبيان - غرفة رقم 4,سني,626,250,7,9,243
طرابلس,الحدادين ,مدرسة الفضيلة للصبيان - غرفة رقم 5,سني,598,218,7,5,211
طرابلس,الحدادين ,مدرسة الفضيلة للصبيان - غرفة رقم 6,سني,628,234,15,4,219
طرابلس,الحدادين ,مدرسة الفضيلة للصبيان - غرفة رقم 7,سني,644,281,14,6,267
طرابلس,الحدادين ,مدرسة الفضيلة للصبيان - غرفة رقم 8,سني,649,296,3,4,293
طرابلس,الحدادين ,مدرسة الفضيلة للصبيان - غرفة رقم 9,سني,625,236,4,3,232
طرابلس,الحدادين ,مدرسة طرابلس الاولى الرسمية للصبيان - غرفة رقم 1,سني,621,221,10,5,211
طرابلس,الحدادين ,مدرسة طرابلس الاولى الرسمية للصبيان - غرفة رقم 10,سني,651,325,13,9,312
طرابلس,الحدادين ,مدرسة طرابلس الاولى الرسمية للصبيان - غرفة رقم 11,سني,653,316,4,11,312
طرابلس,الحدادين ,مدرسة طرابلس الاولى الرسمية للصبيان - غرفة رقم 12,سني,651,284,4,2,280
طرابلس,الحدادين ,مدرسة طرابلس الاولى الرسمية للصبيان - غرفة رقم 13,مختلف,607,233,14,5,219
طرابلس,الحدادين ,مدرسة طرابلس الاولى الرسمية للصبيان - غرفة رقم 14,مختلف,638,159,0,2,159
طرابلس,الحدادين ,مدرسة طرابلس الاولى الرسمية للصبيان - غرفة رقم 2,سني,611,219,17,2,202
طرابلس,الحدادين ,مدرسة طرابلس الاولى الرسمية للصبيان - غرفة رقم 3,سني,601,233,11,6,222
طرابلس,الحدادين ,مدرسة طرابلس الاولى الرسمية للصبيان - غرفة رقم 4,سني,619,243,17,4,226
طرابلس,الحدادين ,مدرسة طرابلس الاولى الرسمية للصبيان - غرفة رقم 5,سني,621,219,6,3,213
طرابلس,الحدادين ,مدرسة طرابلس الاولى الرسمية للصبيان - غرفة رقم 6,سني,611,248,21,3,227
طرابلس,الحدادين ,مدرسة طرابلس الاولى الرسمية للصبيان - غرفة رقم 7,سني,621,217,8,10,209
طرابلس,الحدادين ,مدرسة طرابلس الاولى الرسمية للصبيان - غرفة رقم 8,سني,626,243,15,1,228
طرابلس,الحدادين ,مدرسة طرابلس الاولى الرسمية للصبيان - غرفة رقم 9,سني,619,241,9,4,232
طرابلس,الحديد ,مدرسة التدريب التربوي - غرفة رقم 1,سني,623,219,12,6,207
طرابلس,الحديد ,مدرسة التدريب التربوي - غرفة رقم 10,سني,591,191,5,6,186
طرابلس,الحديد ,مدرسة التدريب التربوي - غرفة رقم 11,سني,621,229,5,4,224
طرابلس,الحديد ,مدرسة التدريب التربوي - غرفة رقم 12,سني,611,251,9,2,242
طرابلس,الحديد ,مدرسة التدريب التربوي - غرفة رقم 13,سني,600,260,17,5,243
طرابلس,الحديد ,مدرسة التدريب التربوي - غرفة رقم 2,سني,646,258,2,5,256
طرابلس,الحديد ,مدرسة التدريب التربوي - غرفة رقم 3,سني,581,254,13,2,241
طرابلس,الحديد ,مدرسة التدريب التربوي - غرفة رقم 4,سني,614,227,5,7,222
طرابلس,الحديد ,مدرسة التدريب التربوي - غرفة رقم 5,سني,625,223,12,2,211
طرابلس,الحديد ,مدرسة التدريب التربوي - غرفة رقم 6,سني,633,242,8,9,234
طرابلس,الحديد ,مدرسة التدريب التربوي - غرفة رقم 7,سني,630,176,0,5,176
طرابلس,الحديد ,مدرسة التدريب التربوي - غرفة رقم 8,سني,622,309,8,4,301
طرابلس,الحديد ,مدرسة التدريب التربوي - غرفة رقم 9,سني,621,231,3,3,228
طرابلس,الحديد ,مدرسة الهدى للصبيان - غرفة رقم 1,سني,617,258,4,7,254
طرابلس,الحديد ,مدرسة الهدى للصبيان - غرفة رقم 2,سني,619,224,9,4,215
طرابلس,الحديد ,مدرسة دوحة الاداب - غرفة رقم 1,سني,623,230,13,8,217
طرابلس,الحديد ,مدرسة دوحة الاداب - غرفة رقم 2,سني,614,221,9,5,212
طرابلس,الحديد ,مدرسة دوحة الاداب - غرفة رقم 3,سني,638,221,10,6,211
طرابلس,الحديد ,مدرسة دوحة الاداب - غرفة رقم 4,سني,647,247,7,9,240
طرابلس,الحديد ,مدرسة دوحة الاداب - غرفة رقم 5,سني,643,305,12,6,293
طرابلس,الرمانة ,مدرسة النموذج الرسمية للصبيان - غرفة رقم 1,سني,632,247,12,4,235
طرابلس,الرمانة ,مدرسة النموذج الرسمية للصبيان - غرفة رقم 2,سني,616,216,1,9,215
طرابلس,الرمانة ,مدرسة النموذج الرسمية للصبيان - غرفة رقم 3,مسيحي,473,94,1,1,93
طرابلس,الرمانة ,مدرسة مي الرسمية الاولى للبنات - غرفة رقم 1,سني,561,225,9,12,216
طرابلس,الرمانة ,مدرسة مي الرسمية الاولى للبنات - غرفة رقم 2,سني,565,215,7,4,208
طرابلس,الرمانة ,مدرسة مي الرسمية الاولى للبنات - غرفة رقم 3,سني,582,234,10,2,224
طرابلس,الرمانة ,مدرسة مي الرسمية الاولى للبنات - غرفة رقم 4,سني,539,206,7,6,199
طرابلس,الرمانة ,مدرسة مي الرسمية الاولى للبنات - غرفة رقم 5,سني,633,242,11,8,231
طرابلس,الرمانة ,مدرسة مي الرسمية الاولى للبنات - غرفة رقم 6,سني,610,204,11,2,193
طرابلس,الزاهرية ,ثانوية فضل المقدم الرسمية للبنات - غرفة رقم 1,سني,569,193,7,3,186
طرابلس,الزاهرية ,ثانوية فضل المقدم الرسمية للبنات - غرفة رقم 2,سني,576,179,7,6,172
طرابلس,الزاهرية ,ثانوية فضل المقدم الرسمية للبنات - غرفة رقم 3,سني,584,269,24,11,245
طرابلس,الزاهرية ,ثانوية فضل المقدم الرسمية للبنات - غرفة رقم 4,سني,566,205,17,0,188
طرابلس,الزاهرية ,ثانوية فضل المقدم الرسمية للبنات - غرفة رقم 5,سني,565,205,8,4,197
طرابلس,الزاهرية ,ثانوية فضل المقدم الرسمية للبنات - غرفة رقم 6,مختلف,551,184,0,7,184
طرابلس,الزاهرية ,مدرسة النموذج الرسمية للصبيان - غرفة رقم 10,مسيحي,534,105,4,2,101
طرابلس,الزاهرية ,مدرسة النموذج الرسمية للصبيان - غرفة رقم 11,مسيحي,479,92,2,5,90
طرابلس,الزاهرية ,مدرسة النموذج الرسمية للصبيان - غرفة رقم 4,روم ارثوذكس,524,116,0,3,116
طرابلس,الزاهرية ,مدرسة النموذج الرسمية للصبيان - غرفة رقم 5,روم ارثوذكس,514,130,3,0,127
طرابلس,الزاهرية ,مدرسة النموذج الرسمية للصبيان - غرفة رقم 6,مسيحي,485,113,1,1,112
طرابلس,الزاهرية ,مدرسة النموذج الرسمية للصبيان - غرفة رقم 7,روم ارثوذكس,526,136,4,2,132
طرابلس,الزاهرية ,مدرسة النموذج الرسمية للصبيان - غرفة رقم 8,روم ارثوذكس,529,141,4,1,137
طرابلس,الزاهرية ,مدرسة النموذج الرسمية للصبيان - غرفة رقم 9,مسيحي,541,129,1,2,128
طرابلس,السويقه ,تكميلية طرابلس الاولى الرسمية للبنات - غرفة رقم 1,سني,606,244,1,7,243
طرابلس,السويقه ,تكميلية طرابلس الاولى الرسمية للبنات - غرفة رقم 10,سني,615,258,9,3,249
طرابلس,السويقه ,تكميلية طرابلس الاولى الرسمية للبنات - غرفة رقم 2,سني,631,260,10,2,250
طرابلس,السويقه ,تكميلية طرابلس الاولى الرسمية للبنات - غرفة رقم 3,سني,621,252,8,6,244
طرابلس,السويقه ,تكميلية طرابلس الاولى الرسمية للبنات - غرفة رقم 4,سني,626,242,15,10,227
طرابلس,السويقه ,تكميلية طرابلس الاولى الرسمية للبنات - غرفة رقم 5,سني,650,269,4,3,265
طرابلس,السويقه ,تكميلية طرابلس الاولى الرسمية للبنات - غرفة رقم 6,سني,608,253,11,10,242
طرابلس,السويقه ,تكميلية طرابلس الاولى الرسمية للبنات - غرفة رقم 7,سني,650,257,12,5,245
طرابلس,السويقه ,تكميلية طرابلس الاولى الرسمية للبنات - غرفة رقم 8,سني,616,246,22,4,224
طرابلس,السويقه ,تكميلية طرابلس الاولى الرسمية للبنات - غرفة رقم 9,سني,609,230,6,4,224
طرابلس,السويقه ,مدرسة التل الجديدة الرسمية للبنات - غرفة رقم 1,سني,615,264,10,5,254
طرابلس,السويقه ,مدرسة التل الجديدة الرسمية للبنات - غرفة رقم 10,سني,581,289,11,6,278
طرابلس,السويقه ,مدرسة التل الجديدة الرسمية للبنات - غرفة رقم 2,سني,636,247,6,8,241
طرابلس,السويقه ,مدرسة التل الجديدة الرسمية للبنات - غرفة رقم 3,سني,650,232,9,4,223
طرابلس,السويقه ,مدرسة التل الجديدة الرسمية للبنات - غرفة رقم 4,سني,632,289,9,6,280
طرابلس,السويقه ,مدرسة التل الجديدة الرسمية للبنات - غرفة رقم 5,سني,618,242,9,9,233
طرابلس,السويقه ,مدرسة التل الجديدة الرسمية للبنات - غرفة رقم 6,سني,625,266,15,4,251
طرابلس,السويقه ,مدرسة التل الجديدة الرسمية للبنات - غرفة رقم 7,سني,635,230,14,6,216
طرابلس,السويقه ,مدرسة التل الجديدة الرسمية للبنات - غرفة رقم 8,سني,620,256,10,7,246
طرابلس,السويقه ,مدرسة التل الجديدة الرسمية للبنات - غرفة رقم 9,سني,565,216,6,1,210
طرابلس,السويقه ,مدرسة فرح انطون الرسمية للصبيان خلف مبنى بلدية طرابلس - غرفة رقم 1,سني,623,263,13,5,250
طرابلس,السويقه ,مدرسة فرح انطون الرسمية للصبيان خلف مبنى بلدية طرابلس - غرفة رقم 2,سني,611,220,22,2,198
طرابلس,السويقه ,مدرسة فرح انطون الرسمية للصبيان خلف مبنى بلدية طرابلس - غرفة رقم 3,سني,650,274,10,7,264
طرابلس,السويقه ,مدرسة فرح انطون الرسمية للصبيان خلف مبنى بلدية طرابلس - غرفة رقم 4,سني,647,236,5,2,231
طرابلس,السويقه ,مدرسة فرح انطون الرسمية للصبيان خلف مبنى بلدية طرابلس - غرفة رقم 5,سني,630,274,10,5,264
طرابلس,السويقه ,مدرسة فرح انطون الرسمية للصبيان خلف مبنى بلدية طرابلس - غرفة رقم 6,سني,608,258,17,2,241
طرابلس,السويقه ,مدرسة مي الرسمية الثانية للبنات - غرفة رقم 1,سني,276,276,7,5,269
طرابلس,السويقه ,مدرسة مي الرسمية الثانية للبنات - غرفة رقم 2,سني,628,235,7,5,228
طرابلس,السويقه ,مدرسة مي الرسمية الثانية للبنات - غرفة رقم 3,سني,629,239,2,3,237
طرابلس,السويقه ,مدرسة مي الرسمية الثانية للبنات - غرفة رقم 4,سني,627,221,9,3,212
طرابلس,السويقه ,مدرسة مي الرسمية الثانية للبنات - غرفة رقم 5,سني,599,232,11,8,221
طرابلس,السويقه ,مدرسة مي الرسمية الثانية للبنات - غرفة رقم 6,سني,564,224,10,2,214
طرابلس,السويقه ,مدرسة مي الرسمية الثانية للبنات - غرفة رقم 7,سني,571,295,8,0,287
طرابلس,القبة ,ثانوية القبة الرسمية المختلطة - غرفة رقم 1,روم ارثوذكس,572,184,7,1,177
طرابلس,القبة ,ثانوية القبة الرسمية المختلطة - غرفة رقم 10,ماروني,597,72,2,2,70
طرابلس,القبة ,ثانوية القبة الرسمية المختلطة - غرفة رقم 2,علوي,560,237,3,1,234
طرابلس,القبة ,ثانوية القبة الرسمية المختلطة - غرفة رقم 3,علوي,552,224,5,0,219
طرابلس,القبة ,ثانوية القبة الرسمية المختلطة - غرفة رقم 4,مختلف,657,227,5,2,222
طرابلس,القبة ,ثانوية القبة الرسمية المختلطة - غرفة رقم 5,ماروني,593,75,0,1,75
طرابلس,القبة ,ثانوية القبة الرسمية المختلطة - غرفة رقم 6,علوي,536,138,0,0,138
طرابلس,القبة ,ثانوية القبة الرسمية المختلطة - غرفة رقم 7,علوي,556,230,4,0,226
طرابلس,القبة ,ثانوية القبة الرسمية المختلطة - غرفة رقم 8,مختلف,672,249,11,3,238
طرابلس,القبة ,ثانوية القبة الرسمية المختلطة - غرفة رقم 9,ماروني,605,73,0,1,73
طرابلس,القبة ,مدرسة ابن سينا الرسمية - غرفة رقم 1,سني,628,270,8,4,262
طرابلس,القبة ,مدرسة ابن سينا الرسمية - غرفة رقم 10,سني,639,293,7,3,286
طرابلس,القبة ,مدرسة ابن سينا الرسمية - غرفة رقم 11,سني,617,259,18,3,241
طرابلس,القبة ,مدرسة ابن سينا الرسمية - غرفة رقم 12,سني,615,311,42,11,269
طرابلس,القبة ,مدرسة ابن سينا الرسمية - غرفة رقم 13,سني,602,254,7,0,247
طرابلس,القبة ,مدرسة ابن سينا الرسمية - غرفة رقم 14,سني,608,281,5,3,276
طرابلس,القبة ,مدرسة ابن سينا الرسمية - غرفة رقم 2,سني,649,294,9,4,285
طرابلس,القبة ,مدرسة ابن سينا الرسمية - غرفة رقم 3,سني,620,260,7,1,253
طرابلس,القبة ,مدرسة ابن سينا الرسمية - غرفة رقم 4,سني,630,268,4,6,264
طرابلس,القبة ,مدرسة ابن سينا الرسمية - غرفة رقم 5,سني,633,259,7,5,252
طرابلس,القبة ,مدرسة ابن سينا الرسمية - غرفة رقم 6,سني,649,176,4,2,172
طرابلس,القبة ,مدرسة ابن سينا الرسمية - غرفة رقم 7,سني,608,253,6,2,247
طرابلس,القبة ,مدرسة ابن سينا الرسمية - غرفة رقم 8,سني,646,226,8,5,218
طرابلس,القبة ,مدرسة ابن سينا الرسمية - غرفة رقم 9,سني,625,288,4,5,284
طرابلس,القبة ,مدرسة الضياء الرسمية للبنات - غرفة رقم 1,روم ارثوذكس,586,99,0,2,99
طرابلس,القبة ,مدرسة الضياء الرسمية للبنات - غرفة رقم 2,روم ارثوذكس,585,108,2,6,106
طرابلس,القبة ,مدرسة الفارابي الرسمية - غرفة رقم 1,سني,592,210,9,1,201
طرابلس,القبة ,مدرسة الفارابي الرسمية - غرفة رقم 2,سني,641,295,17,7,278
طرابلس,القبة ,مدرسة الفارابي الرسمية - غرفة رقم 3,سني,593,213,11,5,202
طرابلس,القبة ,مدرسة الفارابي الرسمية - غرفة رقم 4,سني,628,221,2,2,219
طرابلس,القبة ,مدرسة الفارابي الرسمية - غرفة رقم 5,سني,613,201,10,2,191
طرابلس,القبة ,مدرسة سليمان البستاني للصبيان خلف مبنى بلدية طرابلس - غرفة رقم 1,سني,606,214,8,1,206
طرابلس,القبة ,مدرسة سليمان البستاني للصبيان خلف مبنى بلدية طرابلس - غرفة رقم 2,سني,594,233,13,7,220
طرابلس,القبة ,مدرسة سليمان البستاني للصبيان خلف مبنى بلدية طرابلس - غرفة رقم 3,سني,627,276,10,4,266
طرابلس,القبة ,مدرسة سليمان البستاني للصبيان خلف مبنى بلدية طرابلس - غرفة رقم 4,سني,600,257,8,7,249
طرابلس,القبة ,مدرسة سليمان البستاني للصبيان خلف مبنى بلدية طرابلس - غرفة رقم 5,سني,617,305,22,4,283
طرابلس,القبة ,مدرسة سليمان البستاني للصبيان خلف مبنى بلدية طرابلس - غرفة رقم 6,سني,650,361,11,7,350
طرابلس,القبة ,مدرسة سليمان البستاني للصبيان خلف مبنى بلدية طرابلس - غرفة رقم 7,مختلف,638,279,2,3,277
طرابلس,القلمون ,المدرسة الرسمية للصبيان - غرفة رقم 1,سني,650,279,2,7,277
طرابلس,القلمون ,المدرسة الرسمية للصبيان - غرفة رقم 2,سني,625,290,8,3,282
طرابلس,القلمون ,المدرسة الرسمية للصبيان - غرفة رقم 3,سني,607,245,11,6,234
طرابلس,القلمون ,المدرسة الرسمية للصبيان - غرفة رقم 4,سني,607,279,24,5,255
طرابلس,القلمون ,المدرسة الرسمية للصبيان - غرفة رقم 5,سني,648,361,27,5,334
طرابلس,القلمون ,المدرسة الرسمية للصبيان - غرفة رقم 6,سني,646,346,6,3,340
طرابلس,القلمون ,المدرسة الرسمية للصبيان - غرفة رقم 7,سني,611,318,12,5,306
طرابلس,القلمون ,المدرسة الرسمية للصبيان - غرفة رقم 8,سني,593,359,8,7,351
طرابلس,المهاترة ,مدرسة الفيحاء الرسمية للصبيان - غرفة رقم 1,سني,581,223,14,3,209
طرابلس,المهاترة ,مدرسة الفيحاء الرسمية للصبيان - غرفة رقم 2,سني,608,216,9,6,207
طرابلس,المهاترة ,مدرسة الفيحاء الرسمية للصبيان - غرفة رقم 3,سني,553,251,9,10,242
طرابلس,المهاترة ,مدرسة الفيحاء الرسمية للصبيان - غرفة رقم 4,سني,577,255,18,5,237
طرابلس,المهاترة ,مدرسة الفيحاء الرسمية للصبيان - غرفة رقم 5,سني,607,218,14,4,204
طرابلس,المهاترة ,مدرسة الفيحاء الرسمية للصبيان - غرفة رقم 6,سني,594,239,9,2,230
طرابلس,المهاترة ,مدرسة الفيحاء الرسمية للصبيان - غرفة رقم 7,سني,600,247,7,8,240
طرابلس,المهاترة ,مدرسة الفيحاء الرسمية للصبيان - غرفة رقم 8,سني,592,265,14,6,251
طرابلس,الميناء ,المعهد الفني الصناعي - غرفة رقم 1,سني,596,255,20,0,235
طرابلس,الميناء ,المعهد الفني الصناعي - غرفة رقم 2,سني,602,264,9,5,255
طرابلس,الميناء ,المعهد الفني الصناعي - غرفة رقم 3,سني,605,254,7,5,247
طرابلس,الميناء ,المعهد الفني الصناعي - غرفة رقم 4,سني,603,241,13,3,228
طرابلس,الميناء ,المعهد الفني الصناعي - غرفة رقم 5,سني,617,284,6,4,278
طرابلس,الميناء ,المعهد الفني الصناعي - غرفة رقم 6,سني,622,236,6,4,230
طرابلس,الميناء ,المعهد الفني الصناعي - غرفة رقم 7,سني,571,180,11,1,169
طرابلس,الميناء ,المعهد الفني الصناعي - غرفة رقم 8,سني,599,203,21,3,182
طرابلس,الميناء ,المعهد الفني الصناعي - غرفة رقم 9,سني,594,252,14,6,238
طرابلس,الميناء ,ثانوية اندريه نحاس للبنات - غرفة رقم 1,روم ارثوذكس,607,173,1,1,172
طرابلس,الميناء ,ثانوية اندريه نحاس للبنات - غرفة رقم 2,روم ارثوذكس,608,206,7,3,199
طرابلس,الميناء ,ثانوية اندريه نحاس للبنات - غرفة رقم 3,روم ارثوذكس,611,232,2,6,230
طرابلس,الميناء ,ثانوية اندريه نحاس للبنات - غرفة رقم 4,روم ارثوذكس,582,181,7,4,174
طرابلس,الميناء ,ثانوية اندريه نحاس للبنات - غرفة رقم 5,روم ارثوذكس,558,67,0,1,67
طرابلس,الميناء ,ثانوية اندريه نحاس للبنات - غرفة رقم 6,روم ارثوذكس,590,133,1,1,132
طرابلس,الميناء ,ثانوية اندريه نحاس للبنات - غرفة رقم 7,مسيحي,608,174,2,2,172
طرابلس,الميناء ,ثانوية اندريه نحاس للبنات - غرفة رقم 8,مسيحي,617,180,6,3,174
طرابلس,الميناء ,مدرسة الحياة الرسمية للبنات (BLOCK A) - غرفة رقم 1,أرمن ارثوذكس,565,93,2,0,91
طرابلس,الميناء ,مدرسة الحياة الرسمية للبنات (BLOCK A) - غرفة رقم 2,أرمن ارثوذكس,590,97,2,3,95
طرابلس,الميناء ,مدرسة الحياة الرسمية للبنات (BLOCK B) - غرفة رقم 1,سني,603,254,9,5,245
طرابلس,الميناء ,مدرسة الحياة الرسمية للبنات (BLOCK B) - غرفة رقم 2,سني,617,275,2,5,273
طرابلس,الميناء ,مدرسة الحياة الرسمية للبنات (BLOCK B) - غرفة رقم 3,سني,649,351,8,4,343
طرابلس,الميناء ,مدرسة الحياة الرسمية للبنات (BLOCK B) - غرفة رقم 4,سني,640,346,23,5,323
طرابلس,الميناء ,مدرسة الحياة الرسمية للبنات (BLOCK B) - غرفة رقم 5,سني,654,306,20,2,286
طرابلس,الميناء ,مدرسة النهضة للبنات - غرفة رقم 1,سني,630,266,3,4,263
طرابلس,الميناء ,مدرسة النهضة للبنات - غرفة رقم 2,سني,628,229,14,5,215
طرابلس,الميناء ,مدرسة النهضة للبنات - غرفة رقم 3,سني,610,229,2,7,227
طرابلس,الميناء ,مدرسة النهضة للبنات - غرفة رقم 4,سني,593,224,22,4,202
طرابلس,الميناء ,مدرسة النهضة للبنات - غرفة رقم 5,سني,610,276,8,6,268
طرابلس,الميناء ,مدرسة النهضة للبنات - غرفة رقم 6,سني,627,305,14,5,291
طرابلس,الميناء ,مدرسة النهضة للبنات - غرفة رقم 7,سني,663,383,15,6,368
طرابلس,الميناء ,مدرسة النهضة للبنات - غرفة رقم 8,سني,623,347,21,13,326
طرابلس,الميناء ,مدرسة النهضة للبنات - غرفة رقم 9,سني,320,300,8,4,292
طرابلس,الميناء ,مدرسة عدنان درويش - غرفة رقم 1,سني,630,258,3,2,255
طرابلس,الميناء ,مدرسة عدنان درويش - غرفة رقم 10,سني,629,281,7,2,274
طرابلس,الميناء ,مدرسة عدنان درويش - غرفة رقم 11,سني,631,222,9,2,213
طرابلس,الميناء ,مدرسة عدنان درويش - غرفة رقم 12,سني,628,299,34,0,265
طرابلس,الميناء ,مدرسة عدنان درويش - غرفة رقم 13,سني,616,235,5,7,230
طرابلس,الميناء ,مدرسة عدنان درويش - غرفة رقم 14,سني,617,278,4,1,274
طرابلس,الميناء ,مدرسة عدنان درويش - غرفة رقم 15,سني,618,244,10,1,234
طرابلس,الميناء ,مدرسة عدنان درويش - غرفة رقم 2,سني,614,236,7,4,229
طرابلس,الميناء ,مدرسة عدنان درويش - غرفة رقم 3,سني,615,223,12,3,211
طرابلس,الميناء ,مدرسة عدنان درويش - غرفة رقم 4,سني,618,235,12,1,223
طرابلس,الميناء ,مدرسة عدنان درويش - غرفة رقم 5,سني,615,295,10,5,285
طرابلس,الميناء ,مدرسة عدنان درويش - غرفة رقم 6,سني,607,228,14,3,214
طرابلس,الميناء ,مدرسة عدنان درويش - غرفة رقم 7,سني,628,268,8,6,260
طرابلس,الميناء ,مدرسة عدنان درويش - غرفة رقم 8,سني,628,264,4,6,260
طرابلس,الميناء ,مدرسة عدنان درويش - غرفة رقم 9,سني,608,241,7,4,234
طرابلس,الميناء ,مدرسة لبنان الرسمية الاولى للبنات (المعروفة سابقا الثانوية العربية) - غرفة رقم 1,سني,623,251,5,4,246
طرابلس,الميناء ,مدرسة لبنان الرسمية الاولى للبنات (المعروفة سابقا الثانوية العربية) - غرفة رقم 10,سني,625,249,6,1,243
طرابلس,الميناء ,مدرسة لبنان الرسمية الاولى للبنات (المعروفة سابقا الثانوية العربية) - غرفة رقم 11,سني,619,279,11,1,268
طرابلس,الميناء ,مدرسة لبنان الرسمية الاولى للبنات (المعروفة سابقا الثانوية العربية) - غرفة رقم 12,سني,607,205,9,3,196
طرابلس,الميناء ,مدرسة لبنان الرسمية الاولى للبنات (المعروفة سابقا الثانوية العربية) - غرفة رقم 2,سني,621,254,11,4,243
طرابلس,الميناء ,مدرسة لبنان الرسمية الاولى للبنات (المعروفة سابقا الثانوية العربية) - غرفة رقم 3,سني,216,216,12,3,204
طرابلس,الميناء ,مدرسة لبنان الرسمية الاولى للبنات (المعروفة سابقا الثانوية العربية) - غرفة رقم 4,سني,586,225,7,0,218
طرابلس,الميناء ,مدرسة لبنان الرسمية الاولى للبنات (المعروفة سابقا الثانوية العربية) - غرفة رقم 5,سني,588,250,11,2,239
طرابلس,الميناء ,مدرسة لبنان الرسمية الاولى للبنات (المعروفة سابقا الثانوية العربية) - غرفة رقم 6,سني,605,237,17,10,220
طرابلس,الميناء ,مدرسة لبنان الرسمية الاولى للبنات (المعروفة سابقا الثانوية العربية) - غرفة رقم 7,سني,598,216,8,3,208
طرابلس,الميناء ,مدرسة لبنان الرسمية الاولى للبنات (المعروفة سابقا الثانوية العربية) - غرفة رقم 8,سني,618,244,9,5,235
طرابلس,الميناء ,مدرسة لبنان الرسمية الاولى للبنات (المعروفة سابقا الثانوية العربية) - غرفة رقم 9,سني,616,276,18,0,258
طرابلس,الميناء ,مدرسة ناتالي عازار - غرفة رقم 1,روم ارثوذكس,606,176,0,0,176
طرابلس,الميناء ,مدرسة ناتالي عازار - غرفة رقم 2,روم ارثوذكس,617,215,1,2,214
طرابلس,الميناء ,مدرسة ناتالي عازار - غرفة رقم 3,روم ارثوذكس,618,202,2,9,200
طرابلس,الميناء ,مدرسة ناتالي عازار - غرفة رقم 4,روم ارثوذكس,581,108,2,3,106
طرابلس,الميناء ,مدرسة ناتالي عازار - غرفة رقم 5,روم ارثوذكس,594,120,1,1,119
طرابلس,الميناء ,مدرسة ناتالي عازار - غرفة رقم 6,ماروني,587,129,0,0,129
طرابلس,الميناء ,مدرسة ناتالي عازار - غرفة رقم 7,ماروني,604,99,3,0,96
طرابلس,النوري ,مدرسة النموذج الرسمية للبنات - غرفة رقم 1,سني,272,272,5,8,267
طرابلس,النوري ,مدرسة النموذج الرسمية للبنات - غرفة رقم 10,مختلف,577,165,15,8,150
طرابلس,النوري ,مدرسة النموذج الرسمية للبنات - غرفة رقم 11,مختلف,600,253,12,5,241
طرابلس,النوري ,مدرسة النموذج الرسمية للبنات - غرفة رقم 12,سني,618,287,7,4,280
طرابلس,النوري ,مدرسة النموذج الرسمية للبنات - غرفة رقم 2,سني,636,282,21,11,261
طرابلس,النوري ,مدرسة النموذج الرسمية للبنات - غرفة رقم 3,سني,607,239,10,9,229
طرابلس,النوري ,مدرسة النموذج الرسمية للبنات - غرفة رقم 4,سني,647,258,9,1,249
طرابلس,النوري ,مدرسة النموذج الرسمية للبنات - غرفة رقم 5,سني,614,233,8,0,225
طرابلس,النوري ,مدرسة النموذج الرسمية للبنات - غرفة رقم 6,سني,596,229,16,3,213
طرابلس,النوري ,مدرسة النموذج الرسمية للبنات - غرفة رقم 7,سني,614,225,23,6,202
طرابلس,النوري ,مدرسة النموذج الرسمية للبنات - غرفة رقم 8,مختلف,600,226,12,1,214
طرابلس,النوري ,مدرسة النموذج الرسمية للبنات - غرفة رقم 9,سني,633,280,12,4,268
طرابلس,النوري ,مدرسة مي الرسمية الاولى للبنات - غرفة رقم 10,سني,605,225,7,6,218
طرابلس,النوري ,مدرسة مي الرسمية الاولى للبنات - غرفة رقم 11,سني,614,222,4,0,218
طرابلس,النوري ,مدرسة مي الرسمية الاولى للبنات - غرفة رقم 12,سني,577,233,6,5,227
طرابلس,النوري ,مدرسة مي الرسمية الاولى للبنات - غرفة رقم 13,سني,630,234,12,3,222
طرابلس,النوري ,مدرسة مي الرسمية الاولى للبنات - غرفة رقم 14,سني,657,285,8,6,277
طرابلس,النوري ,مدرسة مي الرسمية الاولى للبنات - غرفة رقم 7,سني,633,241,10,5,231
طرابلس,النوري ,مدرسة مي الرسمية الاولى للبنات - غرفة رقم 8,سني,615,234,15,3,219
طرابلس,النوري ,مدرسة مي الرسمية الاولى للبنات - غرفة رقم 9,سني,644,250,8,6,242
طرابلس,دول إقليمية,دول إقليمية,مختلف,2939,1559,14,8,1545
طرابلس,طرابلس موظفون ,سراي مدينة طرابلس - غرفة رقم 1,مختلف,392,331,10,15,321
طرابلس,طرابلس موظفون ,سراي مدينة طرابلس - غرفة رقم 2,مختلف,303,262,5,10,257
طرابلس,وادي النحلة ,مدرسة الروضة الرسمية - غرفة رقم 1,مسلم,571,413,44,4,369
طرابلس,وادي النحلة ,مدرسة الروضة الرسمية - غرفة رقم 2,مسلم,620,448,23,7,425
عاليه,اغميد ,مركز البلدية (المدرسة الرسمية سابقاً) -  غرفة رقم 1,درزي,514,332,8,5,324
عاليه,اغميد ,مركز البلدية (المدرسة الرسمية سابقاً) -  غرفة رقم 2,درزي,457,239,3,4,236
عاليه,اغميد ,مركز البلدية (المدرسة الرسمية سابقاً) -  غرفة رقم 3,مختلف,417,218,0,2,218
عاليه,البساتين ,المدرسة الرسمية -  غرفة رقم 1,درزي,490,240,1,1,239
عاليه,البساتين ,المدرسة الرسمية -  غرفة رقم 2,درزي,533,272,8,0,264
عاليه,البنيه ,المدرسة الرسمية -  غرفة رقم 1,درزي,623,386,4,16,382
عاليه,البنيه ,المدرسة الرسمية -  غرفة رقم 2,درزي,628,368,3,5,365
عاليه,التعزانية ,كنيسة مار يوسف -  غرفة رقم 1,ماروني,461,223,0,0,223
عاليه,الرجمة ,مركز البلدية -  غرفة رقم 1,روم ارثوذكس,238,133,0,1,133
عاليه,الرمليه ,المدرسة الرسمية -  غرفة رقم 1,درزي,572,284,6,3,278
عاليه,الرمليه ,المدرسة الرسمية -  غرفة رقم 2,درزي,605,301,1,3,300
عاليه,الشويفات حي الامراء ,المدرسة الرسمية المختلطة -  غرفة رقم 1,درزي,634,282,2,5,280
عاليه,الشويفات حي الامراء ,المدرسة الرسمية المختلطة -  غرفة رقم 2,درزي,625,303,0,3,303
عاليه,الشويفات حي الامراء ,المدرسة الرسمية المختلطة -  غرفة رقم 3,مختلف,627,270,1,3,269
عاليه,الشويفات حي الامراء ,المدرسة الرسمية المختلطة -  غرفة رقم 4,درزي,604,275,1,3,274
عاليه,الشويفات حي الامراء ,المدرسة الرسمية المختلطة -  غرفة رقم 5,درزي,632,315,1,1,314
عاليه,الشويفات حي الامراء ,المدرسة الرسمية المختلطة -  غرفة رقم 6,مختلف,610,309,2,0,307
عاليه,الشويفات حي العمروسية ,مبنى البلدية -  غرفة رقم 1,درزي,575,221,1,1,220
عاليه,الشويفات حي العمروسية ,مبنى البلدية -  غرفة رقم 10,روم ارثوذكس,585,216,0,1,216
عاليه,الشويفات حي العمروسية ,مبنى البلدية -  غرفة رقم 11,مسيحي,608,195,3,2,192
عاليه,الشويفات حي العمروسية ,مبنى البلدية -  غرفة رقم 2,درزي,559,251,8,3,243
عاليه,الشويفات حي العمروسية ,مبنى البلدية -  غرفة رقم 3,درزي,582,226,1,1,225
عاليه,الشويفات حي العمروسية ,مبنى البلدية -  غرفة رقم 4,مختلف,561,225,2,1,223
عاليه,الشويفات حي العمروسية ,مبنى البلدية -  غرفة رقم 5,درزي,580,245,2,2,243
عاليه,الشويفات حي العمروسية ,مبنى البلدية -  غرفة رقم 6,درزي,561,259,3,3,256
عاليه,الشويفات حي العمروسية ,مبنى البلدية -  غرفة رقم 7,درزي,567,244,2,1,242
عاليه,الشويفات حي العمروسية ,مبنى البلدية -  غرفة رقم 8,روم ارثوذكس,540,195,2,1,193
عاليه,الشويفات حي العمروسية ,مبنى البلدية -  غرفة رقم 9,مختلف,582,154,2,2,152
عاليه,الشويفات حي القبة ,المدرسة الرسمية للصبيان -  غرفة رقم 1,درزي,625,325,2,0,323
عاليه,الشويفات حي القبة ,المدرسة الرسمية للصبيان -  غرفة رقم 2,درزي,622,288,3,1,285
عاليه,الشويفات حي القبة ,المدرسة الرسمية للصبيان -  غرفة رقم 3,مختلف,607,312,1,2,311
عاليه,الشويفات حي القبة ,المدرسة الرسمية للصبيان -  غرفة رقم 4,مختلف,637,392,29,4,363
عاليه,الشويفات حي القبة ,المدرسة الرسمية للصبيان -  غرفة رقم 5,مختلف,649,352,15,2,337
عاليه,العزونية ,المدرسة الرسمية -  غرفة رقم 1,درزي,580,385,12,1,373
عاليه,العزونية ,المدرسة الرسمية -  غرفة رقم 2,درزي,566,350,1,1,349
عاليه,الغابون ,المدرسة الرسمية -  غرفة رقم 1,درزي,472,348,4,2,344
عاليه,الغابون ,المدرسة الرسمية -  غرفة رقم 2,درزي,471,325,6,2,319
عاليه,الغابون ,المدرسة الرسمية -  غرفة رقم 3,ماروني,249,114,0,1,114
عاليه,القماطية ,المدرسة الرسمية -  غرفة رقم 1,شيعي,551,302,5,3,297
عاليه,القماطية ,المدرسة الرسمية -  غرفة رقم 2,شيعي,532,260,10,0,250
عاليه,القماطية ,المدرسة الرسمية -  غرفة رقم 3,شيعي,543,270,3,2,267
عاليه,القماطية ,المدرسة الرسمية -  غرفة رقم 4,شيعي,555,267,4,0,263
عاليه,القماطية ,المدرسة الرسمية -  غرفة رقم 5,مختلف,515,226,0,2,226
عاليه,الكحالة ,المؤسسة الإنجيلية اللبنانية للرعاية الاجتماعية والتنمية -  غرفة رقم 1,ماروني,573,343,5,2,338
عاليه,الكحالة ,المؤسسة الإنجيلية اللبنانية للرعاية الاجتماعية والتنمية -  غرفة رقم 2,مسيحي,526,294,2,1,292
عاليه,الكحالة ,كنيسة السيدة -  غرفة رقم 1,ماروني,581,354,4,2,350
عاليه,الكحالة ,كنيسة السيدة -  غرفة رقم 2,ماروني,575,354,1,1,353
عاليه,الكحالة ,كنيسة مار الياس -  غرفة رقم 1,ماروني,614,356,1,3,355
عاليه,الكحالة ,كنيسة مار الياس -  غرفة رقم 2,ماروني,596,361,0,1,361
عاليه,المريجات ,كنيسة السيدة -  غرفة رقم 1,ماروني,351,176,6,0,170
عاليه,المشرفه ,المدرسة الرسمية -  غرفة رقم 1,درزي,528,305,6,1,299
عاليه,المشرفه ,المدرسة الرسمية -  غرفة رقم 2,درزي,553,385,0,2,385
عاليه,المشرفه ,المدرسة الرسمية -  غرفة رقم 3,درزي,547,369,3,3,366
عاليه,المنصوريه ,صالون كنيسة مار الياس المنصورية -  غرفة رقم 1,مسيحي,424,238,0,0,238
عاليه,المنصوريه ,صالون كنيسة مار الياس المنصورية -  غرفة رقم 2,مسيحي,430,223,5,2,218
عاليه,بتاتر ,المدرسة الرسمية -  غرفة رقم 1,درزي,599,464,1,2,463
عاليه,بتاتر ,المدرسة الرسمية -  غرفة رقم 2,درزي,594,384,3,0,381
عاليه,بتاتر ,المدرسة الرسمية -  غرفة رقم 3,درزي,574,252,0,0,252
عاليه,بتاتر ,المدرسة الرسمية -  غرفة رقم 4,درزي,594,497,0,2,497
عاليه,بتاتر ,المدرسة الرسمية -  غرفة رقم 5,درزي,574,373,6,2,367
عاليه,بتاتر ,المدرسة الرسمية -  غرفة رقم 6,درزي,584,243,4,1,239
عاليه,بتاتر ,المدرسة الرسمية -  غرفة رقم 7,مسيحي,545,181,0,0,181
عاليه,بحمدون ,كنيسة مار جرجس للروم الارثوذكس -  غرفة رقم 1,روم ارثوذكس,486,278,1,1,277
عاليه,بحمدون ,كنيسة مار جرجس للروم الارثوذكس -  غرفة رقم 2,روم ارثوذكس,499,260,2,1,258
عاليه,بحمدون ,كنيسة مار جرجس للروم الارثوذكس -  غرفة رقم 3,روم ارثوذكس,512,225,2,0,223
عاليه,بحمدون ,كنيسة مار جرجس للروم الارثوذكس -  غرفة رقم 4,روم ارثوذكس,530,265,6,1,259
عاليه,بحمدون ,كنيسة مار جرجس للروم الارثوذكس -  غرفة رقم 5,مسيحي,497,182,6,0,176
عاليه,بحمدون ,كنيسة مار جرجس للروم الارثوذكس -  غرفة رقم 6,مسيحي,451,151,1,1,150
عاليه,بحواره ,بيت جاهز قرب منزل المختار اديب يوسف فرح -  غرفة رقم 1,مسيحي,90,53,1,0,52
عاليه,بخشتيه ,مركز البلدية -  غرفة رقم 1,مسيحي,404,193,1,0,192
عاليه,بخشتيه ,مركز البلدية -  غرفة رقم 2,مسيحي,398,187,2,3,185
عاليه,بدادون ,المدرسة الرسمية -  غرفة رقم 1,ماروني,518,294,1,2,293
عاليه,بدادون ,المدرسة الرسمية -  غرفة رقم 2,مسيحي,504,235,1,5,234
عاليه,بدادون ,المدرسة الرسمية -  غرفة رقم 3,ماروني,540,308,0,1,308
عاليه,بدادون ,المدرسة الرسمية -  غرفة رقم 4,مسيحي,515,220,1,2,219
عاليه,بدغان ,المدرسة الرسمية -  غرفة رقم 1,درزي,501,289,0,3,289
عاليه,بدغان ,المدرسة الرسمية -  غرفة رقم 2,درزي,489,312,1,2,311
عاليه,بسرين ,مركز النادي الثقافي -  غرفة رقم 2,مسيحي,363,169,1,1,168
عاليه,بسرين ,مركز النادي الثقافي الطابق الأرضي -  غرفة رقم 1,مسيحي,325,158,0,0,158
عاليه,بسوس ,بيت اخوية الام الحزينة – قسم مأوى العجزة -  غرفة رقم 1,ماروني,587,303,2,2,301
عاليه,بسوس ,بيت اخوية الام الحزينة – قسم مأوى العجزة -  غرفة رقم 2,مسيحي,541,219,5,0,214
عاليه,بسوس ,بيت اخوية الام الحزينة – قسم مأوى العجزة -  غرفة رقم 3,ماروني,608,309,1,2,308
عاليه,بسوس ,بيت اخوية الام الحزينة – قسم مأوى العجزة -  غرفة رقم 4,ماروني,576,265,1,1,264
عاليه,بشامون ,الثانوية الرسمية -  غرفة رقم 1,درزي,577,289,5,6,284
عاليه,بشامون ,الثانوية الرسمية -  غرفة رقم 2,درزي,580,254,3,4,251
عاليه,بشامون ,الثانوية الرسمية -  غرفة رقم 3,درزي,602,276,3,6,273
عاليه,بشامون ,الثانوية الرسمية -  غرفة رقم 4,درزي,586,233,1,0,232
عاليه,بشامون ,الثانوية الرسمية -  غرفة رقم 5,روم ارثوذكس,528,204,1,4,203
عاليه,بطلون ,كنيسة السيدة بطلون -  غرفة رقم 1,روم ارثوذكس,489,243,2,3,241
عاليه,بعورته ,المدرسة الرسمية -  غرفة رقم 1,درزي,475,226,0,0,226
عاليه,بعورته ,المدرسة الرسمية -  غرفة رقم 2,درزي,540,279,3,4,276
عاليه,بليبل ,مبنى البلدية -  غرفة رقم 1,ماروني,326,208,2,0,206
عاليه,بليبل ,مبنى البلدية -  غرفة رقم 2,ماروني,342,228,0,2,228
عاليه,بمكين ,مدرسة النهضة الوطنية بمكين -  غرفة رقم 1,مسيحي,522,249,2,2,247
عاليه,بمهريه ,مركز البلدية -  غرفة رقم 1,مسيحي,552,305,2,1,303
عاليه,بمهريه ,مركز البلدية -  غرفة رقم 2,مسيحي,556,292,2,0,290
عاليه,بوزريده ,صالة كنيسة سانت ريتا -  غرفة رقم 1,ماروني,270,140,0,0,140
عاليه,بيصور ,المدرسة الرسمية -  غرفة رقم 1,درزي,622,346,3,4,343
عاليه,بيصور ,المدرسة الرسمية -  غرفة رقم 2,درزي,625,316,2,4,314
عاليه,بيصور ,المدرسة الرسمية -  غرفة رقم 3,درزي,622,373,3,7,370
عاليه,بيصور ,المدرسة الرسمية -  غرفة رقم 4,درزي,635,376,3,5,373
عاليه,بيصور ,المدرسة الرسمية -  غرفة رقم 5,درزي,634,322,10,3,312
عاليه,بيصور ,المدرسة الرسمية -  غرفة رقم 6,درزي,634,285,4,4,281
عاليه,بيصور ,المدرسة الرسمية -  غرفة رقم 7,درزي,637,369,1,6,368
عاليه,بيصور ,المدرسة الرسمية -  غرفة رقم 8,درزي,650,353,3,2,350
عاليه,بيصور ,المدرسة الرسمية -  غرفة رقم 9,درزي,609,294,3,1,291
عاليه,جسر القاضي ,بيت جاهز قرب منزل المختار كمال الدبيسي -  غرفة رقم 1,ماروني,61,38,0,0,38
عاليه,حبرامون ,بيت جاهز في باحة الكنيسة -  غرفة رقم 1,مسيحي,255,137,1,2,136
عاليه,حومال ,بلدية حومال -  غرفة رقم 1,ماروني,513,263,2,1,261
عاليه,حومال ,بلدية حومال -  غرفة رقم 2,ماروني,462,226,0,1,226
عاليه,دفون ,مبنى البلدية -  غرفة رقم 1,ماروني,520,246,4,1,242
عاليه,دفون ,مبنى البلدية -  غرفة رقم 2,ماروني,592,271,1,0,270
عاليه,دقون ,نادي شباب دقون -  غرفة رقم 1,ماروني,393,213,1,3,212
عاليه,دقون ,نادي شباب دقون -  غرفة رقم 2,ماروني,423,201,1,4,200
عاليه,دول إقليمية,دول إقليمية,مختلف,2938,1764,17,17,1747
عاليه,دوير الرمان ,صالون الكنيسة في البلدة -  غرفة رقم 1,ماروني,188,86,0,0,86
عاليه,دير قوبل ,المدرسة الرسمية -  غرفة رقم 1,درزي,473,257,4,2,253
عاليه,دير قوبل ,المدرسة الرسمية -  غرفة رقم 2,درزي,469,256,3,0,253
عاليه,دير قوبل ,المدرسة الرسمية -  غرفة رقم 3,مختلف,477,180,2,0,178
عاليه,رشميا ,المدرسة الرسمية -  غرفة رقم 1,ماروني,499,232,3,0,229
عاليه,رشميا ,المدرسة الرسمية -  غرفة رقم 2,ماروني,507,213,0,1,213
عاليه,رشميا ,المدرسة الرسمية -  غرفة رقم 3,مسيحي,503,136,0,0,136
عاليه,رشميا ,المدرسة الرسمية -  غرفة رقم 4,ماروني,536,227,3,3,224
عاليه,رشميا ,المدرسة الرسمية -  غرفة رقم 5,ماروني,537,229,0,4,229
عاليه,رشميا ,المدرسة الرسمية -  غرفة رقم 6,مسيحي,529,116,0,0,116
عاليه,رمحالا ,دير راهبات العائلة المقدسة المارونية في رمحالا -  غرفة رقم 1,ماروني,445,258,0,0,258
عاليه,رمحالا ,دير راهبات العائلة المقدسة المارونية في رمحالا -  غرفة رقم 2,ماروني,438,256,3,1,253
عاليه,رمحالا ,دير راهبات العائلة المقدسة المارونية في رمحالا -  غرفة رقم 3,ماروني,434,134,1,1,133
عاليه,رويسة النعمان ,مركز البلدية -  غرفة رقم 1,ماروني,322,142,0,0,142
عاليه,رويسة النعمان ,مركز البلدية -  غرفة رقم 2,ماروني,324,146,1,1,145
عاليه,سرحمول ,قاعة الشيخ ابو محمد عباس نور الدين -  غرفة رقم 1,درزي,585,331,1,1,330
عاليه,سلفايا ,كنيسة البلدة -  غرفة رقم 1,ماروني,525,287,2,1,285
عاليه,سلفايا ,كنيسة البلدة -  غرفة رقم 2,ماروني,553,295,15,3,280
عاليه,سوق الغرب ,مركز البريد -  غرفة رقم 1,روم ارثوذكس,424,145,1,0,144
عاليه,سوق الغرب ,مركز البريد -  غرفة رقم 2,روم ارثوذكس,436,162,0,1,162
عاليه,سوق الغرب ,مركز البريد -  غرفة رقم 3,مسيحي,421,148,2,1,146
عاليه,سوق الغرب ,مركز البريد -  غرفة رقم 4,مسيحي,345,143,1,0,142
عاليه,شارون ,المدرسة الرسمية -  غرفة رقم 1,درزي,582,342,7,3,335
عاليه,شارون ,المدرسة الرسمية -  غرفة رقم 2,درزي,567,343,3,1,340
عاليه,شارون ,المدرسة الرسمية -  غرفة رقم 3,درزي,572,330,2,3,328
عاليه,شارون ,المدرسة الرسمية -  غرفة رقم 4,درزي,578,330,2,0,328
عاليه,شارون ,المدرسة الرسمية -  غرفة رقم 5,درزي,583,291,1,3,290
عاليه,شارون ,المدرسة الرسمية -  غرفة رقم 6,درزي,602,286,5,0,281
عاليه,شانيه ,المدرسة الرسمية -  غرفة رقم 1,درزي,428,231,3,2,228
عاليه,شانيه ,المدرسة الرسمية -  غرفة رقم 2,درزي,828,413,3,4,410
عاليه,شرتون ,صالون الكنيسة -  غرفة رقم 1,ماروني,525,283,2,1,281
عاليه,شرتون ,صالون الكنيسة -  غرفة رقم 2,ماروني,507,272,4,1,268
عاليه,شرتون ,صالون الكنيسة -  غرفة رقم 3,ماروني,466,77,0,0,77
عاليه,شملان ,بلدية شملان -  غرفة رقم 1,ماروني,344,97,0,0,97
عاليه,شملان ,بلدية شملان -  غرفة رقم 2,ماروني,435,110,0,0,110
عاليه,صوفر ,المدرسة الرسمية -  غرفة رقم 1,درزي,618,335,5,2,330
عاليه,صوفر ,المدرسة الرسمية -  غرفة رقم 2,درزي,625,336,6,6,330
عاليه,صوفر ,المدرسة الرسمية -  غرفة رقم 3,مختلف,580,282,3,3,279
عاليه,عاليه شمالي ,جمعية روضة التهذيب -  غرفة رقم 1,درزي,563,285,7,1,278
عاليه,عاليه شمالي ,جمعية روضة التهذيب -  غرفة رقم 2,درزي,576,299,1,7,298
عاليه,عاليه شمالي ,جمعية روضة التهذيب -  غرفة رقم 3,درزي,562,274,7,3,267
عاليه,عاليه شمالي ,جمعية روضة التهذيب -  غرفة رقم 4,درزي,593,280,5,1,275
عاليه,عاليه شمالي ,جمعية روضة التهذيب -  غرفة رقم 5,درزي,599,266,3,1,263
عاليه,عاليه شمالي ,جمعية روضة التهذيب -  غرفة رقم 6,درزي,588,232,4,2,228
عاليه,عاليه شمالي ,جمعية روضة التهذيب -  غرفة رقم 7,مسيحي,526,124,1,0,123
عاليه,عاليه غربي ,مدرسة عاليه الرسمية الثانية المختلطة -  غرفة رقم 1,روم ارثوذكس,568,173,1,2,172
عاليه,عاليه غربي ,مدرسة عاليه الرسمية الثانية المختلطة -  غرفة رقم 2,مسيحي,561,60,1,0,59
عاليه,عاليه غربي ,مدرسة عاليه الرسمية الثانية المختلطة -  غرفة رقم 3,روم ارثوذكس,552,193,0,0,193
عاليه,عاليه غربي ,مدرسة عاليه الرسمية الثانية المختلطة -  غرفة رقم 4,مسيحي,562,103,1,0,102
عاليه,عاليه غربي ,مدرسة عاليه الرسمية الثانية المختلطة -  غرفة رقم 5,مختلف,570,213,1,1,212
عاليه,عاليه غربي ,مدرسة عاليه الرسمية الثانية المختلطة -  غرفة رقم 6,مختلف,590,217,3,0,214
عاليه,عاليه قبلي ,المدرسة الرسمية الغربية -  غرفة رقم 1,درزي,548,308,2,7,306
عاليه,عاليه قبلي ,المدرسة الرسمية الغربية -  غرفة رقم 2,درزي,525,274,3,3,271
عاليه,عاليه قبلي ,المدرسة الرسمية الغربية -  غرفة رقم 3,مختلف,566,274,6,3,268
عاليه,عاليه قبلي ,المدرسة الرسمية الغربية -  غرفة رقم 4,درزي,526,238,3,2,235
عاليه,عاليه قبلي ,المدرسة الرسمية الغربية -  غرفة رقم 5,درزي,527,259,4,2,255
عاليه,عاليه قبلي ,المدرسة الرسمية الغربية -  غرفة رقم 6,مختلف,542,229,3,0,226
عاليه,عاليه موظفون ,سراي عاليه -  غرفة رقم 1,مختلف,346,305,2,9,303
عاليه,عاليه وسطاني ,ثانوية مارون عبود الرسمية -  غرفة رقم 1,درزي,533,294,8,5,286
عاليه,عاليه وسطاني ,ثانوية مارون عبود الرسمية -  غرفة رقم 2,درزي,545,218,4,3,214
عاليه,عاليه وسطاني ,ثانوية مارون عبود الرسمية -  غرفة رقم 3,درزي,535,242,2,3,240
عاليه,عاليه وسطاني ,ثانوية مارون عبود الرسمية -  غرفة رقم 4,درزي,553,212,5,0,207
عاليه,عاليه وسطاني ,ثانوية مارون عبود الرسمية -  غرفة رقم 5,مسيحي,544,142,0,2,142
عاليه,عبيه ,المدرسة الرسمية -  غرفة رقم 1,درزي,593,311,2,6,309
عاليه,عبيه ,المدرسة الرسمية -  غرفة رقم 2,درزي,591,263,2,4,261
عاليه,عبيه ,المدرسة الرسمية -  غرفة رقم 3,درزي,597,228,2,2,226
عاليه,عبيه ,مستوصف بلدة عبيه عين درافيل -  غرفة رقم 1,مسيحي,466,145,2,0,143
عاليه,عبيه ,مستوصف بلدة عبيه عين درافيل -  غرفة رقم 2,مسيحي,478,133,1,0,132
عاليه,عرمون ,المدرسة الرسمية المختلطة -  غرفة رقم 1,درزي,562,353,2,6,351
عاليه,عرمون ,المدرسة الرسمية المختلطة -  غرفة رقم 10,مختلف,576,243,3,0,240
عاليه,عرمون ,المدرسة الرسمية المختلطة -  غرفة رقم 2,درزي,590,305,4,3,301
عاليه,عرمون ,المدرسة الرسمية المختلطة -  غرفة رقم 3,درزي,598,300,4,1,296
عاليه,عرمون ,المدرسة الرسمية المختلطة -  غرفة رقم 4,درزي,569,280,1,2,279
عاليه,عرمون ,المدرسة الرسمية المختلطة -  غرفة رقم 5,درزي,616,315,2,3,313
عاليه,عرمون ,المدرسة الرسمية المختلطة -  غرفة رقم 6,درزي,567,246,1,1,245
عاليه,عرمون ,المدرسة الرسمية المختلطة -  غرفة رقم 7,درزي,575,276,1,2,275
عاليه,عرمون ,المدرسة الرسمية المختلطة -  غرفة رقم 8,درزي,602,274,5,1,269
عاليه,عرمون ,المدرسة الرسمية المختلطة -  غرفة رقم 9,مختلف,623,215,2,0,213
عاليه,عيتات ,المدرسة الرسمية -  غرفة رقم 1,درزي,465,276,1,1,275
عاليه,عيتات ,المدرسة الرسمية -  غرفة رقم 2,درزي,467,213,6,3,207
عاليه,عيتات ,المدرسة الرسمية -  غرفة رقم 3,درزي,521,290,1,3,289
عاليه,عيتات ,المدرسة الرسمية -  غرفة رقم 4,درزي,521,212,1,1,211
عاليه,عين الجديدة ,كنيسة البلدة -  غرفة رقم 1,روم ارثوذكس,574,346,6,6,340
عاليه,عين الحلزون ,مركز بلدية المنصورية -  غرفة رقم 1,روم ارثوذكس,516,285,6,0,279
عاليه,عين الرمانة ,مدرسة النهضة الوطنية بمكين -  غرفة رقم 2,مسيحي,183,61,1,0,60
عاليه,عين السيدة ,مدرسة النهضة الوطنية بمكين -  غرفة رقم 3,مسيحي,257,94,1,0,93
عاليه,عين الفريديس ,مركز بلدية المنصورية -  غرفة رقم 2,مختلف,56,19,0,0,19
عاليه,عين المرج ,صالون كنيسة مار الياس المنصورية -  غرفة رقم 3,روم ارثوذكس,330,194,0,1,194
عاليه,عين تراز ,صالون كنيسة الموارنة( مار شربل) -  غرفة رقم 1,ماروني,308,156,0,1,156
عاليه,عين تراز ,صالون كنيسة الموارنة( مار شربل) -  غرفة رقم 2,ماروني,310,159,2,0,157
عاليه,عين داره ,ثانوية عين داره الرسمية -  غرفة رقم 1,ماروني,534,294,2,2,292
عاليه,عين داره ,ثانوية عين داره الرسمية -  غرفة رقم 2,ماروني,534,279,1,0,278
عاليه,عين داره ,ثانوية عين داره الرسمية -  غرفة رقم 3,ماروني,522,272,8,3,264
عاليه,عين داره ,ثانوية عين داره الرسمية -  غرفة رقم 4,مسيحي,511,283,9,1,274
عاليه,عين داره ,ثانوية عين داره الرسمية -  غرفة رقم 5,روم ارثوذكس,531,261,2,1,259
عاليه,عين داره ,ثانوية عين داره الرسمية -  غرفة رقم 6,روم ارثوذكس,499,261,4,0,257
عاليه,عين داره ,ثانوية عين داره الرسمية -  غرفة رقم 7,مختلف,549,283,2,2,281
عاليه,عين داره ,ثانوية عين داره الرسمية -  غرفة رقم 8,درزي,484,258,7,0,251
عاليه,عين درافيل ,صالة كنيسة سيدة عين درافيل -  غرفة رقم 1,ماروني,383,213,0,0,213
عاليه,عين عنوب ,المدرسة الرسمية -  غرفة رقم 1,درزي,511,219,3,5,216
عاليه,عين عنوب ,المدرسة الرسمية -  غرفة رقم 2,درزي,501,197,1,2,196
عاليه,عين عنوب ,المدرسة الرسمية -  غرفة رقم 3,مختلف,517,190,1,0,189
عاليه,عين عنوب ,المدرسة الرسمية -  غرفة رقم 4,درزي,542,206,0,0,206
عاليه,عين عنوب ,المدرسة الرسمية -  غرفة رقم 5,درزي,535,194,1,1,193
عاليه,عين عنوب ,المدرسة الرسمية -  غرفة رقم 6,مختلف,511,166,2,0,164
عاليه,عين كسور ,مركز البلدية -  غرفة رقم 1,مختلف,492,190,1,1,189
عاليه,عيناب ,المدرسة الرسمية -  غرفة رقم 1,مختلف,503,197,0,1,197
عاليه,عيناب ,المدرسة الرسمية -  غرفة رقم 2,مختلف,482,203,1,3,202
عاليه,كفر عميه ,كنيسة مار يوسف -  غرفة رقم 1,مسيحي,393,159,4,1,155
عاليه,كفر عميه ,كنيسة مار يوسف -  غرفة رقم 2,مسيحي,423,178,6,0,172
عاليه,كفرمتى ,القاعة العامة -  غرفة رقم 1,درزي,612,416,7,11,409
عاليه,كفرمتى ,القاعة العامة -  غرفة رقم 2,درزي,620,402,4,3,398
عاليه,كفرمتى ,القاعة العامة -  غرفة رقم 3,درزي,645,414,5,8,409
عاليه,كفرمتى ,القاعة العامة -  غرفة رقم 4,درزي,644,390,4,2,386
عاليه,كفرمتى ,صالون كنيسة مار الياس المارونية -  غرفة رقم 1,مسيحي,546,270,6,0,264
عاليه,كفرمتى ,صالون كنيسة مار الياس المارونية -  غرفة رقم 2,مسيحي,570,272,5,0,267
عاليه,كيفون ,المدرسة الرسمية -  غرفة رقم 1,شيعي,543,271,2,4,269
عاليه,كيفون ,المدرسة الرسمية -  غرفة رقم 2,شيعي,621,308,10,1,298
عاليه,مجدل بعنا ,المدرسة الرسمية -  غرفة رقم 1,درزي,635,386,5,4,381
عاليه,مجدل بعنا ,المدرسة الرسمية -  غرفة رقم 2,درزي,624,335,3,2,332
عاليه,مجدل بعنا ,المدرسة الرسمية -  غرفة رقم 3,درزي,627,384,1,3,383
عاليه,مجدل بعنا ,المدرسة الرسمية -  غرفة رقم 4,درزي,639,340,0,6,340
عاليه,مجدلايا ,المدرسة الرسمية -  غرفة رقم 1,درزي,597,388,2,2,386
عاليه,مجدلايا ,المدرسة الرسمية -  غرفة رقم 2,درزي,589,337,2,2,335
عاليه,مجدلايا ,المدرسة الرسمية -  غرفة رقم 3,درزي,601,382,2,4,380
عاليه,مجدلايا ,المدرسة الرسمية -  غرفة رقم 4,درزي,582,333,4,0,329
عاليه,محطة بحمدون ,المدرسة الرسمية -  غرفة رقم 1,روم ارثوذكس,493,187,1,1,186
عاليه,محطة بحمدون ,المدرسة الرسمية -  غرفة رقم 2,روم ارثوذكس,520,192,3,0,189
عاليه,محطة بحمدون ,المدرسة الرسمية -  غرفة رقم 3,مسيحي,375,180,2,0,178
عاليه,مزرعة النهر ,بيت جاهز في ساحة كنيسة مزرعة النهر -  غرفة رقم 1,ماروني,243,92,0,1,92
عاليه,معصريتي ,القاعة العامة في بلدة معصريتي -  غرفة رقم 1,درزي,349,223,1,1,222
عكار,اكروم ,المدرسة الرسمية -  غرفة رقم 1,سني,684,302,0,0,302
عكار,اكروم ,المدرسة الرسمية -  غرفة رقم 2,سني,661,493,1,0,492
عكار,اكروم ,المدرسة الرسمية -  غرفة رقم 3,سني,639,405,8,0,397
عكار,البرج ,المدرسة الرسمية -  غرفة رقم 1,سني,533,193,2,5,191
عكار,البرج ,المدرسة الرسمية -  غرفة رقم 2,سني,521,229,0,3,229
عكار,البرج ,المدرسة الرسمية -  غرفة رقم 3,سني,494,179,2,1,177
عكار,البساتين ,قاعة مسجد البلدة -  غرفة رقم 1,سني,168,104,2,1,102
عكار,البقيعة ,مدرسة الفاتح الكنيسة -  غرفة رقم 1,سني,30,16,1,0,15
عكار,البيره ,الثانوية الرسمية -  غرفة رقم 1,سني,653,333,39,6,294
عكار,البيره ,الثانوية الرسمية -  غرفة رقم 2,سني,646,290,15,3,275
عكار,البيره ,الثانوية الرسمية -  غرفة رقم 3,سني,642,288,13,4,275
عكار,البيره ,الثانوية الرسمية -  غرفة رقم 4,سني,645,264,26,2,238
عكار,البيره ,المدرسة الرسمية -  غرفة رقم 1,سني,613,283,14,1,269
عكار,البيره ,المدرسة الرسمية -  غرفة رقم 2,سني,618,253,12,3,241
عكار,البيره ,المدرسة الرسمية -  غرفة رقم 3,سني,584,240,19,0,221
عكار,البيره ,المدرسة الرسمية -  غرفة رقم 4,سني,601,229,3,0,226
عكار,التليل ,المدرسة الرسمية -  غرفة رقم 1,مسيحي,598,210,6,0,204
عكار,التليل ,المدرسة الرسمية -  غرفة رقم 2,مسيحي,590,271,3,3,268
عكار,الجديده ,المدرسة الرسمية -  غرفة رقم 1,روم ارثوذكس,653,208,6,0,202
عكار,الجديده ,المدرسة الرسمية -  غرفة رقم 2,روم ارثوذكس,590,296,1,5,295
عكار,الجديده ,المدرسة الرسمية -  غرفة رقم 3,روم ارثوذكس,554,267,13,0,254
عكار,الجديده ,المدرسة الرسمية -  غرفة رقم 4,روم ارثوذكس,645,184,4,0,180
عكار,الحميره ,المدرسة الرسمية -  غرفة رقم 1,مسيحي,621,253,1,0,252
عكار,الحويش ,المدرسة الرسمية -  غرفة رقم 1,سني,636,329,2,0,327
عكار,الحويش ,المدرسة الرسمية -  غرفة رقم 2,سني,638,434,3,4,431
عكار,الحويش ,المدرسة الرسمية -  غرفة رقم 3,مختلف,658,336,4,2,332
عكار,الحيصه ,الثانوية الرسمية -  غرفة رقم 1,علوي,672,303,14,2,289
عكار,الحيصه ,الثانوية الرسمية -  غرفة رقم 2,علوي,680,293,20,5,273
عكار,الحيصه ,مدرسة بلانة الحيصا الرسمية -  غرفة رقم 1,سني,539,297,4,1,293
عكار,الحيصه ,مدرسة بلانة الحيصا الرسمية -  غرفة رقم 2,سني,597,365,6,0,359
عكار,الدبابيه ,مدرسة الدبابيه الرسمية -  غرفة رقم 1,مختلف,377,173,0,1,173
عكار,الدبابيه ,مدرسة الدبابيه الرسمية -  غرفة رقم 2,مختلف,360,211,0,1,211
عكار,الدغلي ,المدرسة الرسمية -  غرفة رقم 1,مسلم,400,179,1,0,178
عكار,الدوره ,المدرسة الرسمية -  غرفة رقم 1,سني,625,288,5,1,283
عكار,الدوره ,المدرسة الرسمية -  غرفة رقم 2,مختلف,554,256,6,0,250
عكار,الدوره ,المدرسة الرسمية -  غرفة رقم 3,سني,548,291,7,1,284
عكار,الدوره ,المدرسة الرسمية -  غرفة رقم 4,مختلف,551,282,6,5,276
عكار,الدوسه ,المدرسة الرسمية -  غرفة رقم 1,سني,474,215,16,1,199
عكار,الدوسه ,المدرسة الرسمية -  غرفة رقم 2,سني,479,367,8,1,359
عكار,الرامة ,مدرسة الرامة الرسمية -  غرفة رقم 3,سني,628,406,2,0,404
عكار,الرامة ,مدرسة الرامة الرسمية -  غرفة رقم 4,سني,552,399,4,0,395
عكار,الريحانيه ,المدرسة الرسمية -  غرفة رقم 1,مسلم,754,379,0,0,379
عكار,الزواريب ,مركز البلدية -  غرفة رقم 1,روم ارثوذكس,419,116,1,1,115
عكار,الزواريب ,مركز البلدية -  غرفة رقم 2,روم ارثوذكس,435,162,4,0,158
عكار,السماقية ,المدرسة الرسمية -  غرفة رقم 1,مسلم,617,354,26,5,328
عكار,السماقية ,المدرسة الرسمية -  غرفة رقم 2,مسلم,644,368,11,0,357
عكار,السنديانة ,المدرسة الرسمية -  غرفة رقم 1,سني,471,226,7,1,219
عكار,السنديانة ,المدرسة الرسمية -  غرفة رقم 2,سني,470,314,10,1,304
عكار,السنديانة ,المدرسة الرسمية -  غرفة رقم 3,سني,480,244,3,3,241
عكار,السهلة ,قاعة مسجد البلدة -  غرفة رقم 1,سني,552,224,5,1,219
عكار,السهلة ,قاعة مسجد البلدة -  غرفة رقم 2,سني,549,383,8,0,375
عكار,السويسه ,المدرسة الرسمية -  غرفة رقم 1,سني,570,306,3,2,303
عكار,السويسه ,المدرسة الرسمية -  غرفة رقم 2,سني,574,349,2,6,347
عكار,السويسه ,المدرسة الرسمية -  غرفة رقم 3,سني,531,305,19,1,286
عكار,الشقدوف ,مركز البلدية -  غرفة رقم 1,مختلف,221,72,0,0,72
عكار,الشيخ زناد ,المدرسة الرسمية -  غرفة رقم 1,سني,653,291,16,1,275
عكار,الشيخ زناد ,المدرسة الرسمية -  غرفة رقم 2,سني,706,354,2,4,352
عكار,الشيخ طابا ,المدرسة الرسمية -  غرفة رقم 1,روم ارثوذكس,554,212,9,4,203
عكار,الشيخ طابا ,المدرسة الرسمية -  غرفة رقم 2,روم ارثوذكس,582,273,4,2,269
عكار,الشيخ طابا ,المدرسة الرسمية -  غرفة رقم 3,روم ارثوذكس,562,178,2,0,176
عكار,الشيخ عياش ,المدرسة الرسمية -  غرفة رقم 1,سني,163,106,5,0,101
عكار,الشيخ محمد ,المدرسة الرسمية -  غرفة رقم 1,روم ارثوذكس,649,226,6,0,220
عكار,الشيخ محمد ,المدرسة الرسمية -  غرفة رقم 2,روم ارثوذكس,682,300,22,3,278
عكار,الشيخ محمد ,المدرسة الرسمية -  غرفة رقم 3,مسيحي,653,233,8,1,225
عكار,العبده ,المدرسة الرسمية -  غرفة رقم 1,مختلف,290,151,1,0,150
عكار,العريضه ,المدرسة الرسمية -  غرفة رقم 1,مسلم,499,267,4,1,263
عكار,العريضه ,المدرسة الرسمية -  غرفة رقم 2,مسلم,517,299,6,1,293
عكار,العماير ,مدرسة العماير الرسمية -  غرفة رقم 1,سني,345,258,6,0,252
عكار,العوادة ,مدرسة العواده -  غرفة رقم 1,سني,345,249,8,0,241
عكار,العوينات ,المدرسة الرسمية -  غرفة رقم 1,روم ارثوذكس,501,209,4,0,205
عكار,العوينات ,المدرسة الرسمية -  غرفة رقم 2,روم ارثوذكس,523,278,5,5,273
عكار,العيون ,الثانوية الرسمية -  غرفة رقم 1,سني,527,182,0,1,182
عكار,العيون ,الثانوية الرسمية -  غرفة رقم 2,سني,579,214,12,3,202
عكار,الفرض ,مدرسة الفرض الرسمية -  غرفة رقم 2,سني,348,249,9,3,240
عكار,القبيات الذوق ,المدرسة الرسمية الذوق -  غرفة رقم 1,ماروني,557,266,7,2,259
عكار,القبيات الذوق ,المدرسة الرسمية الذوق -  غرفة رقم 2,ماروني,553,261,1,2,260
عكار,القبيات الذوق ,المدرسة الرسمية الذوق -  غرفة رقم 3,ماروني,551,305,6,2,299
عكار,القبيات الذوق ,المدرسة الرسمية الذوق -  غرفة رقم 4,ماروني,581,306,3,2,303
عكار,القبيات الذوق ,المدرسة الرسمية الذوق -  غرفة رقم 5,ماروني,548,230,4,0,226
عكار,القبيات الذوق ,المدرسة الرسمية الزوق -  غرفة رقم 6,ماروني,433,192,3,1,189
عكار,القبيات الضهر ,ادارة الريجي -  غرفة رقم 1,ماروني,558,285,1,0,284
عكار,القبيات الضهر ,ادارة الريجي -  غرفة رقم 2,ماروني,557,327,4,1,323
عكار,القبيات الضهر ,ادارة الريجي -  غرفة رقم 3,ماروني,520,250,0,0,250
عكار,القبيات الغربية ,وقف كنيسة الاربعين شهيد -  غرفة رقم 1,ماروني,564,285,2,1,283
عكار,القبيات الغربية ,وقف كنيسة الاربعين شهيد -  غرفة رقم 2,ماروني,625,336,1,3,335
عكار,القبيات القطلبه ,نادي الوقف -  غرفة رقم 1,ماروني,552,324,11,1,313
عكار,القبيات القطلبه ,نادي الوقف -  غرفة رقم 2,ماروني,576,397,16,1,381
عكار,القبيات غوايا ,مركز الانعاش الاجتماعي -  غرفة رقم 1,ماروني,502,281,5,3,276
عكار,القبيات غوايا ,مركز الانعاش الاجتماعي -  غرفة رقم 2,ماروني,494,302,0,0,302
عكار,القبيات مرتموره ,التعاونية الزراعية -  غرفة رقم 1,ماروني,502,274,4,2,270
عكار,القبيات مرتموره ,التعاونية الزراعية -  غرفة رقم 2,ماروني,521,308,1,2,307
عكار,القبيات مرتموره ,صالون كنيسة القديسة مور -  غرفة رقم 1,ماروني,476,243,1,3,242
عكار,القرقف ,المدرسة الرسمية -  غرفة رقم 1,سني,659,277,8,0,269
عكار,القرقف ,المدرسة الرسمية -  غرفة رقم 2,سني,668,320,15,2,305
عكار,القرقف ,المدرسة الرسمية -  غرفة رقم 3,سني,669,238,11,0,227
عكار,القرنة ,المدرسة الرسمية -  غرفة رقم 1,سني,920,340,20,6,320
عكار,القرنة ,المدرسة الرسمية -  غرفة رقم 2,سني,654,391,23,3,368
عكار,القرنة ,المدرسة الرسمية -  غرفة رقم 3,سني,638,387,2,3,385
عكار,القرنة ,المدرسة الرسمية -  غرفة رقم 4,سني,623,417,6,2,411
عكار,القريات ,مبنى البلدية -  غرفة رقم 1,ماروني,464,174,11,0,163
عكار,القريات ,مبنى البلدية -  غرفة رقم 2,ماروني,407,213,3,1,210
عكار,القنطره ,المدرسة الرسمية -  غرفة رقم 1,مختلف,421,146,3,0,143
عكار,القنطره ,المدرسة الرسمية -  غرفة رقم 2,مختلف,437,189,2,1,187
عكار,الكنيسة ,المدرسة الرسمية -  غرفة رقم 1,سني,386,209,8,0,201
عكار,الكنيسة ,المدرسة الرسمية -  غرفة رقم 2,سني,429,254,3,0,251
عكار,الكواشره ,المدرسة الرسمية -  غرفة رقم 1,سني,647,345,16,0,329
عكار,الكواشره ,المدرسة الرسمية -  غرفة رقم 2,سني,683,428,7,0,421
عكار,المجدل ,قاعة الجامع -  غرفة رقم 1,سني,388,203,33,0,170
عكار,المجدل ,قاعة الجامع -  غرفة رقم 2,سني,428,300,6,0,294
عكار,المحمرة ,مبنى البلدية -  غرفة رقم 1,سني,474,231,7,5,224
عكار,المحمرة ,مدرسة المقاصد -  غرفة رقم 1,سني,618,321,2,2,319
عكار,المحمرة ,مدرسة المقاصد -  غرفة رقم 2,سني,589,309,4,4,305
عكار,المسعوديه ,المدرسة الرسمية -  غرفة رقم 1,مسلم,639,300,6,2,294
عكار,المسعوديه ,المدرسة الرسمية -  غرفة رقم 2,مسلم,572,266,11,2,255
عكار,المقيبله ,المدرسة الرسمية -  غرفة رقم 1,سني,578,344,4,1,340
عكار,المقيبله ,المدرسة الرسمية -  غرفة رقم 2,سني,711,396,3,0,393
عكار,المقيبله ,المدرسة الرسمية -  غرفة رقم 3,سني,583,356,6,2,350
عكار,المقيبله ,المدرسة الرسمية -  غرفة رقم 4,سني,759,433,13,2,420
عكار,المقيطع ,قاعة مسجد الخضر -  غرفة رقم 1,سني,653,328,23,2,305
عكار,المقيطع ,قاعة مسجد الخضر -  غرفة رقم 2,سني,633,343,26,2,317
عكار,المقيطع ,قاعة مسجد الخضر -  غرفة رقم 3,سني,596,279,8,0,271
عكار,المونسة ,قاعة البلدية -  غرفة رقم 1,سني,731,459,2,1,457
عكار,النفيسه ,مبنى البلدية الحالي -  غرفة رقم 1,ماروني,363,118,0,0,118
عكار,النفيسه ,مبنى البلدية الحالي -  غرفة رقم 2,ماروني,321,126,2,1,124
عكار,النهرية وبستان الحرش ,بهو الكنيسة -  غرفة رقم 1,روم ارثوذكس,225,143,2,0,141
عكار,النورة ,مدرسة النوره الرسمية -  غرفة رقم 1,سني,507,344,16,0,328
عكار,الهد ,بهو الكنيسة -  غرفة رقم 1,ماروني,176,50,0,1,50
عكار,الهيشة ,مدرسة الهيشه -  غرفة رقم 1,سني,704,466,7,4,459
عكار,الهيشة ,مدرسة الهيشه -  غرفة رقم 2,سني,711,527,2,8,525
عكار,ايلات ,المدرسة الرسمية -  غرفة رقم 1,مختلف,538,302,6,4,296
عكار,ايلات ,المدرسة الرسمية -  غرفة رقم 2,مختلف,616,301,2,3,299
عكار,ببنين ,التكميلية الرسمية للبنات -  غرفة رقم 1,سني,661,280,5,5,275
عكار,ببنين ,التكميلية الرسمية للبنات -  غرفة رقم 10,سني,607,225,4,3,221
عكار,ببنين ,التكميلية الرسمية للبنات -  غرفة رقم 11,سني,614,275,17,4,258
عكار,ببنين ,التكميلية الرسمية للبنات -  غرفة رقم 2,سني,661,333,11,3,322
عكار,ببنين ,التكميلية الرسمية للبنات -  غرفة رقم 3,سني,641,274,10,5,264
عكار,ببنين ,التكميلية الرسمية للبنات -  غرفة رقم 4,سني,659,305,26,0,279
عكار,ببنين ,التكميلية الرسمية للبنات -  غرفة رقم 5,سني,608,219,12,0,207
عكار,ببنين ,التكميلية الرسمية للبنات -  غرفة رقم 6,سني,608,298,5,2,293
عكار,ببنين ,التكميلية الرسمية للبنات -  غرفة رقم 7,سني,613,255,2,3,253
عكار,ببنين ,التكميلية الرسمية للبنات -  غرفة رقم 8,سني,331,286,9,2,277
عكار,ببنين ,التكميلية الرسمية للبنات -  غرفة رقم 9,سني,619,225,12,2,213
عكار,ببنين ,ثانوية رفيق الحريري الرسمية -  غرفة رقم 1,سني,717,317,17,3,300
عكار,ببنين ,ثانوية رفيق الحريري الرسمية -  غرفة رقم 10,سني,763,333,7,0,326
عكار,ببنين ,ثانوية رفيق الحريري الرسمية -  غرفة رقم 2,سني,709,321,7,3,314
عكار,ببنين ,ثانوية رفيق الحريري الرسمية -  غرفة رقم 3,سني,722,277,9,0,268
عكار,ببنين ,ثانوية رفيق الحريري الرسمية -  غرفة رقم 4,سني,690,337,13,0,324
عكار,ببنين ,ثانوية رفيق الحريري الرسمية -  غرفة رقم 5,سني,691,301,4,2,297
عكار,ببنين ,ثانوية رفيق الحريري الرسمية -  غرفة رقم 6,سني,714,305,1,4,304
عكار,ببنين ,ثانوية رفيق الحريري الرسمية -  غرفة رقم 7,سني,673,254,4,2,250
عكار,ببنين ,ثانوية رفيق الحريري الرسمية -  غرفة رقم 8,سني,677,266,5,1,261
عكار,ببنين ,ثانوية رفيق الحريري الرسمية -  غرفة رقم 9,سني,716,288,8,0,280
عكار,برباره ,دار البلدية -  غرفة رقم 1,علوي,314,161,3,0,158
عكار,برج العرب ,المدرسة التكميلية الرسمية -  غرفة رقم 1,سني,391,255,0,0,255
عكار,برج العرب ,المدرسة التكميلية الرسمية -  غرفة رقم 2,سني,418,306,6,1,300
عكار,برقايل ,الثانوية الرسمية -  غرفة رقم 1,سني,649,342,19,3,323
عكار,برقايل ,الثانوية الرسمية -  غرفة رقم 2,سني,635,338,9,0,329
عكار,برقايل ,الثانوية الرسمية -  غرفة رقم 3,سني,614,289,15,6,274
عكار,برقايل ,الثانوية الرسمية -  غرفة رقم 4,سني,650,256,1,1,255
عكار,برقايل ,المدرسة الرسمية -  غرفة رقم 1,سني,603,313,5,13,308
عكار,برقايل ,المدرسة الرسمية -  غرفة رقم 2,سني,612,323,15,2,308
عكار,برقايل ,المدرسة الرسمية -  غرفة رقم 3,سني,643,324,5,6,319
عكار,برقايل ,المدرسة الرسمية -  غرفة رقم 4,سني,626,310,6,2,304
عكار,برقايل ,المدرسة الرسمية -  غرفة رقم 5,سني,583,336,6,3,330
عكار,برقايل ,المدرسة الرسمية -  غرفة رقم 6,سني,630,314,60,3,254
عكار,برقايل ,مدرسة الربيع -  غرفة رقم 1,سني,637,317,4,7,313
عكار,برقايل ,مدرسة الربيع -  غرفة رقم 2,سني,636,304,9,0,295
عكار,برقايل ,مدرسة الربيع -  غرفة رقم 3,سني,627,282,10,8,272
عكار,بزال ,المدرسة الرسمية -  غرفة رقم 1,سني,656,339,2,2,337
عكار,بزال ,المدرسة الرسمية -  غرفة رقم 2,سني,581,404,8,0,396
عكار,بزال ,المدرسة الرسمية -  غرفة رقم 3,سني,697,435,2,1,433
عكار,بزبينا ,تجمع صفوف الروضات الطابق الأرضي -  غرفة رقم 1,سني,486,191,7,1,184
عكار,بزبينا ,تجمع صفوف الروضات الطابق الأرضي -  غرفة رقم 2,سني,535,227,3,1,224
عكار,بزبينا ,تجمع صفوف الروضات الطابق الأرضي -  غرفة رقم 3,روم ارثوذكس,499,188,13,2,175
عكار,بزبينا ,تجمع صفوف الروضات الطابق الأرضي -  غرفة رقم 4,روم ارثوذكس,513,233,2,2,231
عكار,بزبينا ,تجمع صفوف الروضات الطابق الأرضي -  غرفة رقم 5,روم ارثوذكس,511,186,5,6,181
عكار,بقرزلا ,المدرسة الرسمية -  غرفة رقم 1,ماروني,571,145,2,0,143
عكار,بقرزلا ,المدرسة الرسمية -  غرفة رقم 2,ماروني,573,127,2,1,125
عكار,بقرزلا ,المدرسة الرسمية -  غرفة رقم 3,ماروني,602,193,6,2,187
عكار,بقرزلا ,المدرسة الرسمية -  غرفة رقم 4,ماروني,557,148,5,0,143
عكار,بقرزلا ,المدرسة الرسمية -  غرفة رقم 5,ماروني,558,104,2,2,102
عكار,بني صخر ,ثانوية الشهيد وليد عيدو الرسمية في محلة البقيعة -  غرفة رقم 1,سني,309,237,4,0,233
عكار,بيت الحاج ,مبنى البلدية -  غرفة رقم 1,سني,586,287,10,4,277
عكار,بيت الحوش ,بيت جاهز في ساحة البلدة -  غرفة رقم 1,سني,204,90,4,0,86
عكار,بيت ايوب ,المدرسة الرسمية -  غرفة رقم 1,سني,603,301,11,1,290
عكار,بيت ايوب ,المدرسة الرسمية -  غرفة رقم 2,سني,579,364,4,5,360
عكار,بيت غطاس ,بهو الكنيسة -  غرفة رقم 1,مختلف,220,63,3,1,60
عكار,بيت ملات ,مبنى البلدية -  غرفة رقم 1,ماروني,591,167,1,0,166
عكار,بيت ملات ,مبنى البلدية -  غرفة رقم 2,ماروني,572,129,4,0,125
عكار,بيت ملات ,مبنى البلدية -  غرفة رقم 3,ماروني,558,168,1,0,167
عكار,بيت ملات ,مبنى البلدية -  غرفة رقم 4,ماروني,554,148,0,1,148
عكار,بيت يونس ,المدرسة الرسمية -  غرفة رقم 1,سني,659,315,1,0,314
عكار,بيت يونس ,المدرسة الرسمية -  غرفة رقم 2,سني,606,410,0,0,410
عكار,بينو ,مدرسة بينو الرسمية المختلطة -  غرفة رقم 1,روم ارثوذكس,509,96,0,0,96
عكار,بينو ,مدرسة بينو الرسمية المختلطة -  غرفة رقم 2,روم ارثوذكس,493,114,0,0,114
عكار,بينو ,مدرسة بينو الرسمية المختلطة -  غرفة رقم 3,مسيحي,570,97,14,0,83
عكار,بينو ,مدرسة بينو الرسمية المختلطة -  غرفة رقم 4,روم ارثوذكس,485,102,1,0,101
عكار,بينو ,مدرسة بينو الرسمية المختلطة -  غرفة رقم 5,روم ارثوذكس,508,127,1,1,126
عكار,بينو ,مدرسة بينو الرسمية المختلطة -  غرفة رقم 6,مسيحي,483,101,0,0,101
عكار,تاشع ,مركز البلدية -  غرفة رقم 1,مختلف,743,391,6,1,385
عكار,تاشع ,مركز البلدية -  غرفة رقم 2,مختلف,744,374,2,2,372
عكار,تكريت ,المدرسة الرسمية -  غرفة رقم 1,سني,645,284,6,0,278
عكار,تكريت ,المدرسة الرسمية -  غرفة رقم 2,سني,625,269,3,1,266
عكار,تكريت ,المدرسة الرسمية -  غرفة رقم 3,سني,633,260,10,0,250
عكار,تكريت ,المدرسة الرسمية -  غرفة رقم 4,مختلف,599,208,9,7,199
عكار,تكريت ,المدرسة الرسمية -  غرفة رقم 5,سني,660,334,0,0,334
عكار,تكريت ,المدرسة الرسمية -  غرفة رقم 6,سني,667,334,5,4,329
عكار,تكريت ,المدرسة الرسمية -  غرفة رقم 7,سني,642,281,17,3,264
عكار,تكريت ,المدرسة الرسمية -  غرفة رقم 8,مختلف,664,270,12,4,258
عكار,تل عباس شرقي ,مدرسة الشهيد باسل الاسد -  غرفة رقم 1,مسلم,577,193,16,0,177
عكار,تل عباس غربي ,المدرسة الرسمية -  غرفة رقم 1,روم ارثوذكس,493,163,4,0,159
عكار,تل عباس غربي ,المدرسة الرسمية -  غرفة رقم 2,روم ارثوذكس,496,163,2,2,161
عكار,تل عباس غربي ,المدرسة الرسمية -  غرفة رقم 3,روم ارثوذكس,511,213,2,1,211
عكار,تل عباس غربي ,المدرسة الرسمية -  غرفة رقم 4,روم ارثوذكس,542,219,3,0,216
عكار,تل عباس غربي ,المدرسة الرسمية -  غرفة رقم 5,مسيحي,539,286,11,0,275
عكار,تل معيان ,المدرسة الرسمية الحديثة -  غرفة رقم 1,سني,610,347,9,2,338
عكار,تل معيان ,المدرسة الرسمية الحديثة -  غرفة رقم 2,مسلم,661,311,2,1,309
عكار,تل معيان ,المدرسة الرسمية الحديثة -  غرفة رقم 3,سني,550,354,1,3,353
عكار,تل معيان ,المدرسة الرسمية الحديثة -  غرفة رقم 4,مسلم,667,324,11,0,313
عكار,تلبيبة ,المدرسة الرسمية -  غرفة رقم 1,مسلم,569,206,7,3,199
عكار,تلبيره ,المدرسة الرسمية -  غرفة رقم 1,علوي,647,304,5,2,299
عكار,تلبيره ,المدرسة الرسمية -  غرفة رقم 2,علوي,612,254,2,2,252
عكار,تلبيره ,المدرسة الرسمية -  غرفة رقم 3,مسلم,629,284,5,0,279
عكار,تلحميره ,المدرسة الرسمية -  غرفة رقم 1,مسلم,555,270,5,1,265
عكار,تلحميره ,المدرسة الرسمية -  غرفة رقم 2,مسلم,550,301,14,0,287
عكار,تله وشطاحه ,صالون كنيسة البلدة -  غرفة رقم 1,ماروني,352,123,1,0,122
عكار,تله وشطاحه ,صالون كنيسة البلدة -  غرفة رقم 2,ماروني,353,124,1,2,123
عكار,جبرايل ,دار البلدية -  غرفة رقم 1,روم ارثوذكس,484,171,4,0,167
عكار,جبرايل ,دار البلدية -  غرفة رقم 2,روم ارثوذكس,473,86,0,0,86
عكار,جبرايل ,دار البلدية -  غرفة رقم 3,روم ارثوذكس,481,218,1,3,217
عكار,جبرايل ,دار البلدية -  غرفة رقم 4,روم ارثوذكس,463,91,1,1,90
عكار,جبل المنصورة ,مدرسة مشتى حمود الرسمية -  غرفة رقم 6,سني,80,58,1,0,57
عكار,جديدة القيطع ,المدرسة الرسمية -  غرفة رقم 1,سني,633,358,10,5,348
عكار,جديدة القيطع ,المدرسة الرسمية -  غرفة رقم 2,سني,618,326,13,3,313
عكار,جديدة القيطع ,المدرسة الرسمية -  غرفة رقم 3,سني,587,396,33,1,363
عكار,جديدة القيطع ,المدرسة الرسمية -  غرفة رقم 4,سني,590,394,7,4,387
عكار,جرمنايا ,مدرسة الرامة الرسمية -  غرفة رقم 5,سني,65,46,0,0,46
عكار,حبشيت ,المدرسة الرسمية -  غرفة رقم 1,شيعي,660,242,9,1,233
عكار,حبشيت ,المدرسة الرسمية -  غرفة رقم 2,شيعي,696,302,44,0,258
عكار,حرار ,المدرسة الرسمية -  غرفة رقم 1,سني,594,306,1,1,305
عكار,حرار ,المدرسة الرسمية -  غرفة رقم 2,سني,598,261,4,0,257
عكار,حرار ,المدرسة الرسمية -  غرفة رقم 3,سني,554,325,12,1,313
عكار,حرار ,المدرسة الرسمية -  غرفة رقم 4,سني,568,272,2,3,270
عكار,حرار ,المدرسة الرسمية -  غرفة رقم 5,مختلف,557,300,7,3,293
عكار,حكر الشيخ طابا ,بهو الكنيسة -  غرفة رقم 1,روم ارثوذكس,505,232,3,1,229
عكار,حكر الضاهري ,المدرسة الرسمية -  غرفة رقم 1,مسلم,403,252,2,0,250
عكار,حلبا ,التكميلية الرسمية -  غرفة رقم 1,روم ارثوذكس,622,205,8,3,197
عكار,حلبا ,التكميلية الرسمية -  غرفة رقم 2,روم ارثوذكس,593,208,10,3,198
عكار,حلبا ,التكميلية الرسمية -  غرفة رقم 3,سني,575,249,5,7,244
عكار,حلبا ,التكميلية الرسمية -  غرفة رقم 4,سني,591,234,14,2,220
عكار,حلبا ,التكميلية الرسمية -  غرفة رقم 5,سني,577,197,3,1,194
عكار,حلبا ,التكميلية الرسمية -  غرفة رقم 6,سني,563,224,15,4,209
عكار,حلبا ,التكميلية الرسمية -  غرفة رقم 7,مختلف,579,241,14,1,227
عكار,حلبا ,الثانوية الرسمية -  غرفة رقم 1,روم ارثوذكس,593,187,1,2,186
عكار,حلبا ,الثانوية الرسمية -  غرفة رقم 2,روم ارثوذكس,565,181,1,1,180
عكار,حلبا ,الثانوية الرسمية -  غرفة رقم 3,سني,582,279,12,3,267
عكار,حلبا ,الثانوية الرسمية -  غرفة رقم 4,سني,593,239,42,2,197
عكار,حلبا ,الثانوية الرسمية -  غرفة رقم 5,سني,598,208,19,4,189
عكار,حلبا ,الثانوية الرسمية -  غرفة رقم 6,سني,605,285,15,7,270
عكار,حنيدر ,المدرسة الرسمية -  غرفة رقم 1,علوي,560,148,7,4,141
عكار,حنيدر ,المدرسة الرسمية -  غرفة رقم 2,علوي,569,189,6,1,183
عكار,حنيدر ,المدرسة الرسمية -  غرفة رقم 3,علوي,607,104,16,1,88
عكار,حنيدر ,المدرسة الرسمية -  غرفة رقم 4,علوي,605,145,9,1,136
عكار,حوشب ,المدرسة الرسمية الجديدة -  غرفة رقم 1,مسلم,512,206,7,0,199
عكار,حوشب ,المدرسة الرسمية الجديدة -  غرفة رقم 2,مسلم,487,215,4,0,211
عكار,حيزوق ,المدرسة الرسمية -  غرفة رقم 1,سني,667,239,2,3,237
عكار,حيزوق ,المدرسة الرسمية -  غرفة رقم 2,سني,674,285,12,1,273
عكار,خربة الجرد ,المدرسة الرسمية -  غرفة رقم 1,ماروني,475,189,6,0,183
عكار,خربة داوود ,المدرسة الرسمية في خربة داوود -  غرفة رقم 1,سني,396,237,2,0,235
عكار,خربة داوود ,المدرسة الرسمية في خربة داوود -  غرفة رقم 2,سني,389,289,8,1,281
عكار,خربة شار ,المدرسة الرسمية -  غرفة رقم 1,سني,763,484,4,0,480
عكار,خريبة الجندي ,المدرسة الرسمية -  غرفة رقم 1,سني,597,242,7,1,235
عكار,خريبة الجندي ,المدرسة الرسمية -  غرفة رقم 2,سني,573,233,6,3,227
عكار,خريبة الجندي ,المدرسة الرسمية -  غرفة رقم 3,سني,587,278,7,3,271
عكار,خط البترول ,ثانوية الشهيد وليد عيدو الرسمية في محلة البقيعة -  غرفة رقم 2,سني,260,217,4,1,213
عكار,دارين ,بيت جاهز في ساحة البلدة قرب منزل عبد الكريم ياسين -  غرفة رقم 1,مسلم,686,252,0,0,252
عكار,دول إقليمية,دول إقليمية,مختلف,4775,2553,51,18,2502
عكار,دوير عدويه ,بهو الجامع -  غرفة رقم 1,سني,551,254,10,2,244
عكار,دير جنين ,مبنى البلدية -  غرفة رقم 1,ماروني,424,133,1,0,132
عكار,دير جنين ,مبنى البلدية -  غرفة رقم 2,ماروني,388,143,9,0,134
عكار,دير دلوم ,مدرسة ذوق المقشرين في بلدة دير دلوم -  غرفة رقم 1,مسيحي,160,22,0,1,22
عكار,رجم عيسى ,مدرسة رجم عيسى -  غرفة رقم 4,سني,504,357,7,0,350
عكار,رحبه ,المدرسة الرسمية للبنات -  غرفة رقم 1,روم ارثوذكس,601,168,5,1,163
عكار,رحبه ,المدرسة الرسمية للبنات -  غرفة رقم 2,روم ارثوذكس,594,248,6,3,242
عكار,رحبه ,المدرسة الرسمية للبنات -  غرفة رقم 3,روم ارثوذكس,636,247,4,3,243
عكار,رحبه ,المدرسة الرسمية للبنات -  غرفة رقم 4,روم ارثوذكس,625,222,6,1,216
عكار,رحبه ,المدرسة الرسمية للبنات -  غرفة رقم 5,روم ارثوذكس,604,120,9,1,111
عكار,رحبه ,المدرسة الرسمية للصبيان -  غرفة رقم 1,روم ارثوذكس,622,144,3,1,141
عكار,رحبه ,المدرسة الرسمية للصبيان -  غرفة رقم 2,روم ارثوذكس,604,197,1,2,196
عكار,رحبه ,المدرسة الرسمية للصبيان -  غرفة رقم 3,روم ارثوذكس,605,189,8,3,181
عكار,رحبه ,المدرسة الرسمية للصبيان -  غرفة رقم 4,روم ارثوذكس,605,169,1,1,168
عكار,رحبه ,المدرسة الرسمية للصبيان -  غرفة رقم 5,روم ارثوذكس,588,128,9,1,119
عكار,رحبه ,المدرسة الرسمية للصبيان -  غرفة رقم 6,روم ارثوذكس,605,148,8,4,140
عكار,رماح ,المدرسة الرسمية -  غرفة رقم 1,روم ارثوذكس,437,127,7,1,120
عكار,رماح ,المدرسة الرسمية -  غرفة رقم 2,روم ارثوذكس,439,156,6,0,150
عكار,زوق الحبالصه ,المدرسة الرسمية -  غرفة رقم 1,سني,669,292,10,4,282
عكار,زوق الحصينه ,المدرسة الرسمية الحديثة -  غرفة رقم 1,سني,627,300,11,1,289
عكار,زوق الحصينه ,المدرسة الرسمية الحديثة -  غرفة رقم 2,سني,612,345,7,1,338
عكار,زوق الحصينه ,المدرسة الرسمية الحديثة -  غرفة رقم 3,سني,572,317,9,2,308
عكار,زوق الحصينه ,المدرسة الرسمية الحديثة -  غرفة رقم 4,سني,576,319,11,0,308
عكار,زوق المقشرين ,مدرسة ذوق المقشرين في بلدة دير دلوم -  غرفة رقم 2,روم ارثوذكس,334,80,0,0,80
عكار,زوق المقشرين ,مدرسة ذوق المقشرين في بلدة دير دلوم -  غرفة رقم 3,روم ارثوذكس,329,101,1,0,100
عكار,زوق حداره ,القاعة المحاذية لمسجد البلدة -  غرفة رقم 1,سني,433,167,1,4,166
عكار,زوق حداره ,القاعة المحاذية لمسجد البلدة -  غرفة رقم 2,سني,434,172,3,0,169
عكار,سرار ,بيت جاهز – قرب منزل المختار احمد نجده -  غرفة رقم 1,مختلف,705,319,3,4,316
عكار,سعدين ,بيت جاهز قرب منزل المختار عزمي المحمد -  غرفة رقم 1,مختلف,421,167,1,1,166
عكار,سفينة الدريب ,مركز البلدية -  غرفة رقم 1,ماروني,407,207,4,3,203
عكار,سفينة القيطع ,المدرسة الرسمية -  غرفة رقم 1,سني,764,398,13,1,385
عكار,سفينة القيطع ,المدرسة الرسمية -  غرفة رقم 2,سني,782,391,5,5,386
عكار,سيسوق ,قاعة كنيسة مار الياس -  غرفة رقم 1,ماروني,550,256,8,1,248
عكار,شان ,مبنى البلدية -  غرفة رقم 1,سني,694,397,1,0,396
عكار,شان ,مبنى البلدية -  غرفة رقم 2,سني,705,450,3,2,447
عكار,شدره ,المدرسة الرسمية -  غرفة رقم 1,روم ارثوذكس,524,217,3,0,214
عكار,شدره ,المدرسة الرسمية -  غرفة رقم 2,روم ارثوذكس,551,245,2,3,243
عكار,شدره ,المدرسة الرسمية -  غرفة رقم 3,روم ارثوذكس,527,214,2,1,212
عكار,شدره ,المدرسة الرسمية -  غرفة رقم 4,روم ارثوذكس,512,265,0,2,265
عكار,شدره ,المدرسة الرسمية -  غرفة رقم 5,روم ارثوذكس,525,273,15,3,258
عكار,شدره ,المدرسة الرسمية -  غرفة رقم 6,روم ارثوذكس,526,251,4,1,247
عكار,شدره ,المدرسة الرسمية -  غرفة رقم 7,مسيحي,526,170,1,0,169
عكار,شربيلا ,مركز البلدية -  غرفة رقم 1,روم ارثوذكس,438,109,0,1,109
عكار,شربيلا ,مركز البلدية -  غرفة رقم 2,روم ارثوذكس,430,138,1,2,137
عكار,شيخلار ,بهو الكنيسة -  غرفة رقم 1,روم ارثوذكس,286,134,2,0,132
عكار,ضهر القنبر ,مبنى البلدية -  غرفة رقم 1,مسلم,330,183,6,2,177
عكار,ضهر ليسينه ,المدرسة الرسمية -  غرفة رقم 1,روم ارثوذكس,549,204,3,2,201
عكار,عبودية ,مبنى الجمارك -  غرفة رقم 1,سني,593,250,11,3,239
عكار,عبودية ,مبنى الجمارك -  غرفة رقم 2,سني,600,272,2,3,270
عكار,عبودية ,مبنى الجمارك -  غرفة رقم 3,مسلم,648,340,3,0,337
عكار,عدبل ,المدرسة الرسمية -  غرفة رقم 1,مسيحي,642,234,6,0,228
عكار,عدبل ,المدرسة الرسمية -  غرفة رقم 2,مسيحي,609,277,1,1,276
عكار,عرقا ,مركز البلدية الحالي -  غرفة رقم 1,سني,260,162,4,1,158
عكار,عكار العتيقه ,الثانوية الرسمية -  غرفة رقم 1,سني,665,282,15,0,267
عكار,عكار العتيقه ,الثانوية الرسمية -  غرفة رقم 10,سني,673,431,15,2,416
عكار,عكار العتيقه ,الثانوية الرسمية -  غرفة رقم 11,سني,661,443,24,1,419
عكار,عكار العتيقه ,الثانوية الرسمية -  غرفة رقم 12,سني,663,389,7,1,382
عكار,عكار العتيقه ,الثانوية الرسمية -  غرفة رقم 13,سني,670,434,31,6,403
عكار,عكار العتيقه ,الثانوية الرسمية -  غرفة رقم 14,مختلف,648,367,8,2,359
عكار,عكار العتيقه ,الثانوية الرسمية -  غرفة رقم 2,سني,717,305,2,0,303
عكار,عكار العتيقه ,الثانوية الرسمية -  غرفة رقم 3,سني,349,311,3,1,308
عكار,عكار العتيقه ,الثانوية الرسمية -  غرفة رقم 4,سني,662,295,1,2,294
عكار,عكار العتيقه ,الثانوية الرسمية -  غرفة رقم 5,سني,679,322,6,2,316
عكار,عكار العتيقه ,الثانوية الرسمية -  غرفة رقم 6,سني,645,328,35,0,293
عكار,عكار العتيقه ,الثانوية الرسمية -  غرفة رقم 7,مختلف,634,283,1,4,282
عكار,عكار العتيقه ,الثانوية الرسمية -  غرفة رقم 8,سني,683,400,15,2,385
عكار,عكار العتيقه ,الثانوية الرسمية -  غرفة رقم 9,سني,666,376,17,4,359
عكار,عكار موظفون ,سراي حلبا -  غرفة رقم 1,مختلف,439,375,2,14,373
عكار,عكار موظفون ,سراي حلبا -  غرفة رقم 2,مختلف,512,415,6,11,409
عكار,عكار موظفون ,سراي حلبا -  غرفة رقم 3,مختلف,446,381,4,16,377
عكار,عمار البيكات ,المدرسة الرسمية -  غرفة رقم 1,سني,710,325,0,0,325
عكار,عماره ,المدرسة الرسمية -  غرفة رقم 1,سني,59,50,0,0,50
عكار,عندقت ,مدرسة القلبين الاقدسين عندقت -  غرفة رقم 1,ماروني,593,252,1,0,251
عكار,عندقت ,مدرسة القلبين الاقدسين عندقت -  غرفة رقم 2,ماروني,588,249,5,2,244
عكار,عندقت ,مدرسة القلبين الاقدسين عندقت -  غرفة رقم 3,ماروني,577,260,5,3,255
عكار,عندقت ,مدرسة القلبين الاقدسين عندقت -  غرفة رقم 4,ماروني,591,327,20,2,307
عكار,عندقت ,مدرسة القلبين الاقدسين عندقت -  غرفة رقم 5,ماروني,596,266,4,0,262
عكار,عندقت ,مدرسة القلبين الاقدسين عندقت -  غرفة رقم 6,ماروني,584,309,0,4,309
عكار,عندقت ,مدرسة القلبين الاقدسين عندقت -  غرفة رقم 7,ماروني,567,242,2,3,240
عكار,عيات ,المدرسة الرسمية -  غرفة رقم 1,سني,573,208,6,0,202
عكار,عيات ,المدرسة الرسمية -  غرفة رقم 2,سني,559,205,8,3,197
عكار,عيات ,المدرسة الرسمية -  غرفة رقم 3,سني,561,226,3,1,223
عكار,عيات ,المدرسة الرسمية -  غرفة رقم 4,سني,584,225,14,4,211
عكار,عيات ,المدرسة الرسمية -  غرفة رقم 5,سني,505,164,4,2,160
عكار,عيدمون ,المدرسة الرسمية -  غرفة رقم 1,سني,579,301,5,1,296
عكار,عيدمون ,المدرسة الرسمية -  غرفة رقم 2,مختلف,527,235,2,0,233
عكار,عيدمون ,المدرسة الرسمية -  غرفة رقم 3,سني,570,399,6,3,393
عكار,عيدمون ,المدرسة الرسمية -  غرفة رقم 4,مختلف,531,254,10,2,244
عكار,عين الذهب ,المدرسة الرسمية -  غرفة رقم 1,سني,626,293,1,1,292
عكار,عين الذهب ,المدرسة الرسمية -  غرفة رقم 2,سني,587,265,10,3,255
عكار,عين الذهب ,المدرسة الرسمية -  غرفة رقم 3,سني,648,380,0,0,380
عكار,عين الذهب ,المدرسة الرسمية -  غرفة رقم 4,سني,656,277,2,0,275
عكار,عين الذهب ,مدرسة الروضة الرسمية -  غرفة رقم 1,سني,631,293,4,0,289
عكار,عين الذهب ,مدرسة الروضة الرسمية -  غرفة رقم 2,سني,657,290,0,0,290
عكار,عين الذهب ,مدرسة الروضة الرسمية -  غرفة رقم 3,سني,623,345,13,1,332
عكار,عين الذهب ,مدرسة الروضة الرسمية -  غرفة رقم 4,سني,654,266,18,0,248
عكار,عين الذهب ,مدرسة الروضة الرسمية -  غرفة رقم 5,سني,641,306,8,0,298
عكار,عين الزيت ,المدرسة الرسمية في عين الزيت -  غرفة رقم 1,علوي,550,208,3,4,205
عكار,عين الزيت ,المدرسة الرسمية في عين الزيت -  غرفة رقم 2,علوي,550,468,9,3,459
عكار,عين تنتا ,مركز البلدية -  غرفة رقم 1,سني,562,321,2,1,319
عكار,عين يعقوب ,المدرسة الرسمية -  غرفة رقم 1,سني,508,160,10,0,150
عكار,عين يعقوب ,المدرسة الرسمية -  غرفة رقم 2,سني,496,165,40,1,125
عكار,عين يعقوب ,المدرسة الرسمية -  غرفة رقم 3,مختلف,486,151,2,5,149
عكار,عيون الغزلان ,بهو الجامع -  غرفة رقم 1,سني,418,239,0,2,239
عكار,غزيله ,قاعة مسجد البلدة -  غرفة رقم 1,مسلم,467,232,13,6,219
عكار,فريديس ,القاعة العامة الملاصقة لمسجد البلدة -  غرفة رقم 1,سني,286,156,4,0,152
عكار,فنيدق ,التكميلية الرسمية -  غرفة رقم 1,سني,619,311,4,1,307
عكار,فنيدق ,التكميلية الرسمية -  غرفة رقم 10,سني,666,371,18,0,353
عكار,فنيدق ,التكميلية الرسمية -  غرفة رقم 2,سني,633,400,0,1,400
عكار,فنيدق ,التكميلية الرسمية -  غرفة رقم 3,سني,661,356,2,1,354
عكار,فنيدق ,التكميلية الرسمية -  غرفة رقم 4,سني,625,339,1,0,338
عكار,فنيدق ,التكميلية الرسمية -  غرفة رقم 5,سني,680,356,18,0,338
عكار,فنيدق ,التكميلية الرسمية -  غرفة رقم 6,سني,646,356,16,0,340
عكار,فنيدق ,التكميلية الرسمية -  غرفة رقم 7,سني,616,321,22,1,299
عكار,فنيدق ,التكميلية الرسمية -  غرفة رقم 8,سني,671,385,9,2,376
عكار,فنيدق ,التكميلية الرسمية -  غرفة رقم 9,سني,641,332,3,0,329
عكار,فنيدق ,مدرسة المقاصد -  غرفة رقم 1,سني,661,356,2,1,354
عكار,فنيدق ,مدرسة المقاصد -  غرفة رقم 10,سني,608,365,1,0,364
عكار,فنيدق ,مدرسة المقاصد -  غرفة رقم 2,سني,593,418,7,1,411
عكار,فنيدق ,مدرسة المقاصد -  غرفة رقم 3,سني,621,398,1,4,397
عكار,فنيدق ,مدرسة المقاصد -  غرفة رقم 4,سني,617,366,4,3,362
عكار,فنيدق ,مدرسة المقاصد -  غرفة رقم 5,سني,612,380,3,1,377
عكار,فنيدق ,مدرسة المقاصد -  غرفة رقم 6,سني,616,377,7,2,370
عكار,فنيدق ,مدرسة المقاصد -  غرفة رقم 7,سني,624,380,6,0,374
عكار,فنيدق ,مدرسة المقاصد -  غرفة رقم 8,سني,627,370,0,0,370
عكار,فنيدق ,مدرسة المقاصد -  غرفة رقم 9,سني,624,394,4,0,390
عكار,قبة بشمرا ,المدرسة الرسمية -  غرفة رقم 1,سني,559,277,7,4,270
عكار,قبعيت ,الثانوية الرسمية -  غرفة رقم 1,سني,707,357,0,2,357
عكار,قبعيت ,الثانوية الرسمية -  غرفة رقم 2,سني,692,303,7,0,296
عكار,قبعيت ,الثانوية الرسمية -  غرفة رقم 3,سني,671,380,12,1,368
عكار,قبعيت ,الثانوية الرسمية -  غرفة رقم 4,سني,688,330,3,1,327
عكار,قبولا ,المدرسة الرسمية المختلطة -  غرفة رقم 1,روم ارثوذكس,477,130,0,2,130
عكار,قرحا ,المدرسة الرسمية -  غرفة رقم 1,شيعي,381,154,7,0,147
عكار,قرحا ,المدرسة الرسمية -  غرفة رقم 2,شيعي,331,158,4,0,154
عكار,قرحا ,المدرسة الرسمية -  غرفة رقم 3,علوي,794,256,19,4,237
عكار,قشلق ,القاعة المسجد -  غرفة رقم 1,سني,437,238,2,0,236
عكار,قشلق ,القاعة المسجد -  غرفة رقم 2,سني,407,229,10,1,219
عكار,قلود الباقية ,قاعة الكنيسة -  غرفة رقم 1,ماروني,150,64,1,0,63
عكار,قليعات ,المدرسة الرسمية -  غرفة رقم 1,سني,645,350,11,3,339
عكار,قليعات ,المدرسة الرسمية -  غرفة رقم 2,سني,633,363,4,0,359
عكار,قليعات ,المدرسة الرسمية -  غرفة رقم 3,سني,641,327,11,2,316
عكار,قليعات ,المدرسة الرسمية -  غرفة رقم 4,سني,640,347,7,3,340
عكار,قنية ,المدرسة الرسمية -  غرفة رقم 1,سني,596,239,6,2,233
عكار,قنية ,المدرسة الرسمية -  غرفة رقم 2,سني,594,467,5,0,462
عكار,كرم زبدين ,مهنية وادي خالد -  غرفة رقم 3,سني,36,28,0,0,28
عكار,كرم عصفور ,المدرسة الرسمية -  غرفة رقم 1,مسيحي,446,84,0,0,84
عكار,كرم عصفور ,المدرسة الرسمية -  غرفة رقم 2,مسيحي,438,138,2,1,136
عكار,كروم عرب ,المدرسة الرسمية -  غرفة رقم 1,سني,479,251,3,1,248
عكار,كفر حره ,قاعة كنيسة السيدة -  غرفة رقم 1,روم ارثوذكس,364,120,3,0,117
عكار,كفرتون ,ثانوية كفرتون الرسمية -  غرفة رقم 1,سني,579,247,7,0,240
عكار,كفرتون ,ثانوية كفرتون الرسمية -  غرفة رقم 2,سني,601,255,7,1,248
عكار,كفرتون ,ثانوية كفرتون الرسمية -  غرفة رقم 3,سني,574,482,13,0,469
عكار,كفرتون ,ثانوية كفرتون الرسمية -  غرفة رقم 4,سني,585,466,6,0,460
عكار,كفرنون ,بهو الكنيسة -  غرفة رقم 1,ماروني,263,136,0,0,136
عكار,كوشا ,المدرسة الرسمية -  غرفة رقم 1,سني,563,268,0,1,268
عكار,كوشا ,المدرسة الرسمية -  غرفة رقم 2,سني,555,266,1,0,265
عكار,كويخات ,قاعة البلدية -  غرفة رقم 1,سني,535,411,11,0,400
عكار,مار توما ,مبنى البلدية -  غرفة رقم 1,سني,381,177,0,0,177
عكار,مار توما ,مبنى البلدية -  غرفة رقم 2,سني,359,178,2,0,176
عكار,مجدلا ,المدرسة الرسمية -  غرفة رقم 1,سني,514,244,6,0,238
عكار,مجدلا ,المدرسة الرسمية -  غرفة رقم 2,سني,529,264,7,3,257
عكار,مجدلا ,المدرسة الرسمية -  غرفة رقم 3,سني,529,211,6,0,205
عكار,مراح الخوخ ,مركز الدفاع المدني -  غرفة رقم 1,سني,571,343,2,0,341
عكار,مزرعة بلده ,المدرسة الرسمية -  غرفة رقم 1,مختلف,853,316,8,2,308
عكار,مزرعة بلده ,المدرسة الرسمية -  غرفة رقم 2,سني,201,91,4,1,87
عكار,مزرعة بلده ,المدرسة الرسمية -  غرفة رقم 3,مختلف,420,205,3,1,202
عكار,مشتى حسن ,المدرسة الرسمية -  غرفة رقم 1,سني,5182,197,11,1,186
عكار,مشتى حسن ,المدرسة الرسمية -  غرفة رقم 2,سني,517,197,0,4,197
عكار,مشتى حسن ,المدرسة الرسمية -  غرفة رقم 3,سني,539,242,19,1,223
عكار,مشتى حسن ,المدرسة الرسمية -  غرفة رقم 4,سني,554,220,12,4,208
عكار,مشتى حسن ,المدرسة الرسمية -  غرفة رقم 5,سني,556,238,10,0,228
عكار,مشتى حمود ,مدرسة مشتى حمود الرسمية -  غرفة رقم 1,سني,650,261,5,2,256
عكار,مشتى حمود ,مدرسة مشتى حمود الرسمية -  غرفة رقم 2,سني,662,270,10,0,260
عكار,مشتى حمود ,مدرسة مشتى حمود الرسمية -  غرفة رقم 3,سني,642,332,6,4,326
عكار,مشتى حمود ,مدرسة مشتى حمود الرسمية -  غرفة رقم 4,سني,662,341,11,2,330
عكار,مشتى حمود ,مدرسة مشتى حمود الرسمية -  غرفة رقم 5,سني,654,293,8,4,285
عكار,مشحا ,التكميلية الرسمية -  غرفة رقم 1,سني,606,262,11,5,251
عكار,مشحا ,التكميلية الرسمية -  غرفة رقم 2,سني,588,276,5,4,271
عكار,مشحا ,التكميلية الرسمية -  غرفة رقم 3,سني,597,271,0,0,271
عكار,مشحا ,ثانوية مشحة الرسمية -  غرفة رقم 1,سني,584,256,4,1,252
عكار,مشحا ,ثانوية مشحة الرسمية -  غرفة رقم 2,سني,583,276,5,3,271
عكار,مشمش ,المدرسة الرسمية (المبنى الجديد) -  غرفة رقم 1,سني,676,276,7,1,269
عكار,مشمش ,المدرسة الرسمية (المبنى الجديد) -  غرفة رقم 2,سني,640,392,9,0,383
عكار,مشمش ,المدرسة الرسمية (المبنى الجديد) -  غرفة رقم 3,سني,599,323,0,1,323
عكار,مشمش ,المدرسة الرسمية (المبنى الجديد) -  غرفة رقم 4,سني,635,314,1,0,313
عكار,مشمش ,المدرسة الرسمية (المبنى الجديد) -  غرفة رقم 5,سني,613,298,5,1,293
عكار,مشمش ,المدرسة الرسمية (المبنى الجديد) -  غرفة رقم 6,سني,626,408,3,1,405
عكار,مشمش ,المدرسة الرسمية (المبنى الجديد) -  غرفة رقم 7,سني,659,269,3,0,266
عكار,مشمش ,المدرسة الرسمية (المبنى الجديد) -  غرفة رقم 8,سني,635,387,1,2,386
عكار,مشمش ,مدرسة المقاصد -  غرفة رقم 1,سني,676,276,7,1,269
عكار,مشمش ,مدرسة المقاصد -  غرفة رقم 2,سني,679,359,13,1,346
عكار,مشمش ,مدرسة المقاصد -  غرفة رقم 3,سني,655,309,2,1,307
عكار,مشمش ,مدرسة المقاصد -  غرفة رقم 4,سني,654,279,5,0,274
عكار,مشمش ,مدرسة المقاصد -  غرفة رقم 5,سني,642,291,8,2,283
عكار,مشمش ,مدرسة المقاصد -  غرفة رقم 6,سني,640,352,9,0,343
عكار,مشمش ,مدرسة المقاصد -  غرفة رقم 7,سني,615,286,10,0,276
عكار,مشمش ,مدرسة المقاصد -  غرفة رقم 8,سني,611,320,3,2,317
عكار,مشيلحة حاكوره ,المدرسة الرسمية -  غرفة رقم 1,روم ارثوذكس,468,60,0,0,60
عكار,مشيلحة حاكوره ,المدرسة الرسمية -  غرفة رقم 2,روم ارثوذكس,459,88,0,0,88
عكار,مشيلحة حاكوره ,المدرسة الرسمية -  غرفة رقم 3,مسيحي,446,26,1,0,25
عكار,ممنع ,مركز البلدية -  غرفة رقم 1,ماروني,569,206,2,1,204
عكار,ممنع ,مركز البلدية -  غرفة رقم 2,ماروني,537,201,6,1,195
عكار,منجز ,مركز الدفاع المدني -  غرفة رقم 1,ماروني,526,195,3,2,192
عكار,منجز ,مركز الدفاع المدني -  غرفة رقم 2,ماروني,502,210,5,0,205
عكار,منياره ,المدرسة الرسمية للبنات -  غرفة رقم 1,روم ارثوذكس,579,200,7,2,193
عكار,منياره ,المدرسة الرسمية للبنات -  غرفة رقم 2,روم ارثوذكس,581,167,3,3,164
عكار,منياره ,المدرسة الرسمية للبنات -  غرفة رقم 3,روم ارثوذكس,595,188,2,2,186
عكار,منياره ,المدرسة الرسمية للبنات -  غرفة رقم 4,روم ارثوذكس,569,273,5,4,268
عكار,منياره ,المدرسة الرسمية للبنات -  غرفة رقم 5,روم ارثوذكس,581,227,1,2,226
عكار,منياره ,المدرسة الرسمية للبنات -  غرفة رقم 6,مسيحي,570,227,8,2,219
عكار,منياره ,المدرسة الرسمية للبنات -  غرفة رقم 7,مسيحي,600,164,7,1,157
عكار,منياره ,المدرسة الرسمية للبنات -  غرفة رقم 8,مسيحي,587,195,1,0,194
عكار,هيتلا ,المدرسة الرسمية -  غرفة رقم 1,مختلف,452,186,2,0,184
عكار,هيتلا ,المدرسة الرسمية -  غرفة رقم 2,مختلف,417,228,3,2,225
عكار,وادي الجاموس ,المدرسة الرسمية -  غرفة رقم 1,سني,659,378,6,0,372
عكار,وادي الجاموس ,المدرسة الرسمية -  غرفة رقم 2,سني,645,341,12,4,329
عكار,وادي الجاموس ,المدرسة الرسمية -  غرفة رقم 3,سني,612,323,8,1,315
عكار,وادي الجاموس ,المدرسة الرسمية -  غرفة رقم 4,سني,570,259,9,3,250
عكار,وادي الجاموس ,المدرسة الرسمية -  غرفة رقم 5,سني,562,279,12,5,267
عكار,وادي الجاموس ,المدرسة الرسمية -  غرفة رقم 6,سني,544,276,16,2,260
عكار,وادي الحور ,المدرسة الرسمية -  غرفة رقم 1,سني,528,316,1,1,315
عكار,وادي خالد ,مدرسة الرامة الرسمية -  غرفة رقم 1,سني,521,281,4,2,277
عكار,وادي خالد ,مدرسة الرامة الرسمية -  غرفة رقم 2,مسلم,936,384,9,2,375
عكار,وادي خالد ,مدرسة الهيشة الرسمية -  غرفة رقم 1,سني,559,304,16,4,288
عكار,وادي خالد ,مدرسة الهيشة الرسمية -  غرفة رقم 2,سني,687,411,24,1,387
عكار,وادي خالد ,مدرسة الهيشة الرسمية -  غرفة رقم 3,سني,700,418,4,0,414
عكار,وادي خالد ,مدرسة بهية الحريري الرسمية في بلدة المجدل -  غرفة رقم 1,سني,646,373,8,0,365
عكار,وادي خالد ,مدرسة بهية الحريري الرسمية في بلدة المجدل -  غرفة رقم 2,سني,674,391,17,5,374
عكار,وادي خالد ,مدرسة رجم عيسى -  غرفة رقم 1,سني,684,390,41,5,349
عكار,وادي خالد ,مدرسة رجم عيسى -  غرفة رقم 2,سني,671,427,22,2,405
عكار,وادي خالد ,مدرسة رجم عيسى -  غرفة رقم 3,سني,729,377,10,0,367
قرى صيدا,ارزي ,المدرسة الرسمية - غرفة رقم 1,شيعي,542,266,3,4,263
قرى صيدا,ارزي ,المدرسة الرسمية - غرفة رقم 2,شيعي,544,301,2,2,299
قرى صيدا,ارزي ,المدرسة الرسمية - غرفة رقم 3,شيعي,573,308,5,3,303
قرى صيدا,ارزي ,المدرسة الرسمية - غرفة رقم 4,شيعي,534,320,6,1,314
قرى صيدا,اركي ,المدرسة الرسمية - غرفة رقم 1,شيعي,516,263,3,5,260
قرى صيدا,اركي ,المدرسة الرسمية - غرفة رقم 2,شيعي,497,288,6,0,282
قرى صيدا,اركي ,المدرسة الرسمية - غرفة رقم 3,شيعي,504,312,3,5,309
قرى صيدا,البابلية ,الثانوية الرسمية - غرفة رقم 1,شيعي,622,334,4,3,330
قرى صيدا,البابلية ,الثانوية الرسمية - غرفة رقم 2,شيعي,618,273,6,1,267
قرى صيدا,البابلية ,الثانوية الرسمية - غرفة رقم 3,شيعي,618,271,8,1,263
قرى صيدا,البابلية ,المدرسة الرسمية - غرفة رقم 1,شيعي,610,364,8,5,356
قرى صيدا,البابلية ,المدرسة الرسمية - غرفة رقم 2,شيعي,598,317,5,3,312
قرى صيدا,البابلية ,المدرسة الرسمية - غرفة رقم 3,شيعي,581,283,6,5,277
قرى صيدا,البرامية ,مركز البلدية - غرفة رقم 1,مسيحي,577,153,7,5,146
قرى صيدا,البرامية ,مركز البلدية - غرفة رقم 2,مسيحي,602,118,3,3,115
قرى صيدا,البيسارية ,المدرسة الرسمية - غرفة رقم 1,شيعي,534,372,6,4,366
قرى صيدا,البيسارية ,المدرسة الرسمية - غرفة رقم 2,شيعي,542,369,13,7,356
قرى صيدا,البيسارية ,المدرسة الرسمية - غرفة رقم 3,شيعي,524,387,3,4,384
قرى صيدا,البيسارية ,المدرسة الرسمية - غرفة رقم 4,شيعي,524,345,7,5,338
قرى صيدا,البيسارية ,النادي الحسيني ( خراج بلدة الصرفند) - غرفة رقم 1,سني,482,159,3,1,156
قرى صيدا,البيسارية ,النادي الحسيني ( خراج بلدة الصرفند) - غرفة رقم 2,سني,477,220,9,3,211
قرى صيدا,الحارة ,النادي الحسيني - غرفة رقم 1,شيعي,610,389,5,5,384
قرى صيدا,الحارة ,النادي الحسيني - غرفة رقم 2,شيعي,619,381,5,1,376
قرى صيدا,الحارة ,ثانوية حارة صيدا الرسمية - غرفة رقم 1,شيعي,639,405,10,4,395
قرى صيدا,الحارة ,ثانوية حارة صيدا الرسمية - غرفة رقم 2,شيعي,665,439,4,5,435
قرى صيدا,الحارة ,ثانوية حارة صيدا الرسمية - غرفة رقم 3,مسلم,673,439,2,12,437
قرى صيدا,الحجة ,كنيسة مار يوسف - غرفة رقم 1,مسيحي,464,175,4,3,171
قرى صيدا,الحجة ,كنيسة مار يوسف - غرفة رقم 2,مسيحي,470,158,2,5,156
قرى صيدا,الخرايب ,المدرسة الرسمية (البلدية) - غرفة رقم 1,شيعي,616,345,12,15,333
قرى صيدا,الخرايب ,المدرسة الرسمية (البلدية) - غرفة رقم 2,شيعي,594,293,11,0,282
قرى صيدا,الخرايب ,المدرسة الرسمية (البلدية) - غرفة رقم 3,شيعي,537,306,10,3,296
قرى صيدا,الخرايب ,المدرسة الرسمية (البلدية) - غرفة رقم 4,شيعي,578,305,15,4,290
قرى صيدا,الخرايب ,المدرسة الرسمية (البلدية) - غرفة رقم 5,شيعي,545,324,6,5,318
قرى صيدا,الخرايب ,المدرسة الرسمية (البلدية) - غرفة رقم 6,شيعي,552,307,9,4,298
قرى صيدا,الخرايب ,المدرسة الرسمية (البلدية) - غرفة رقم 7,شيعي,625,320,4,1,316
قرى صيدا,الخرايب ,المدرسة الرسمية (البلدية) - غرفة رقم 8,شيعي,624,312,11,5,301
قرى صيدا,الزرارية ,تكميلية الزرارية الرسمية - المبنى الجديد - غرفة رقم 1,شيعي,591,209,4,3,205
قرى صيدا,الزرارية ,تكميلية الزرارية الرسمية - المبنى الجديد - غرفة رقم 2,شيعي,579,231,7,0,224
قرى صيدا,الزرارية ,تكميلية الزرارية الرسمية - المبنى الجديد - غرفة رقم 3,شيعي,620,225,2,1,223
قرى صيدا,الزرارية ,تكميلية الزرارية الرسمية - المبنى الجديد - غرفة رقم 4,شيعي,620,239,4,0,235
قرى صيدا,الزرارية ,تكميلية الزرارية الرسمية - المبنى الجديد - غرفة رقم 5,شيعي,620,205,4,1,201
قرى صيدا,الزرارية ,ثانوية الزرارية الرسمية - غرفة رقم 1,شيعي,610,275,3,1,272
قرى صيدا,الزرارية ,ثانوية الزرارية الرسمية - غرفة رقم 2,شيعي,631,286,8,2,278
قرى صيدا,الزرارية ,ثانوية الزرارية الرسمية - غرفة رقم 3,شيعي,598,297,6,4,291
قرى صيدا,الزرارية ,ثانوية الزرارية الرسمية - غرفة رقم 4,شيعي,606,305,9,3,296
قرى صيدا,الزرارية ,ثانوية الزرارية الرسمية - غرفة رقم 5,شيعي,621,246,5,0,241
قرى صيدا,السكسكية ,المدرسة الرسمية - غرفة رقم 1,شيعي,597,359,10,5,349
قرى صيدا,السكسكية ,المدرسة الرسمية - غرفة رقم 2,شيعي,600,377,11,1,366
قرى صيدا,السكسكية ,المدرسة الرسمية - غرفة رقم 3,شيعي,582,371,7,7,364
قرى صيدا,السكسكية ,المدرسة الرسمية - غرفة رقم 4,شيعي,574,382,5,3,377
قرى صيدا,السكسكية ,المدرسة الرسمية - غرفة رقم 5,شيعي,585,323,2,3,321
قرى صيدا,السكسكية ,ثانوية السكسكية الرسمية - المبنى الجديد - غرفة رقم 1,شيعي,603,345,5,6,340
قرى صيدا,السكسكية ,ثانوية السكسكية الرسمية - المبنى الجديد - غرفة رقم 2,شيعي,605,358,5,3,353
قرى صيدا,السكسكية ,ثانوية السكسكية الرسمية - المبنى الجديد - غرفة رقم 3,شيعي,595,355,15,3,340
قرى صيدا,السكسكية ,ثانوية السكسكية الرسمية - المبنى الجديد - غرفة رقم 4,شيعي,611,369,8,6,361
قرى صيدا,الصالحية ,المدرسة الرسمية (البلدية) - غرفة رقم 1,مسيحي,435,112,2,6,110
قرى صيدا,الصالحية ,المدرسة الرسمية (البلدية) - غرفة رقم 2,مسيحي,439,89,1,0,88
قرى صيدا,الصرفند ,التكميلية الرسمية - المبنى الجديد - غرفة رقم 1,شيعي,595,348,14,9,334
قرى صيدا,الصرفند ,التكميلية الرسمية - المبنى الجديد - غرفة رقم 2,شيعي,600,346,14,4,332
قرى صيدا,الصرفند ,التكميلية الرسمية - المبنى الجديد - غرفة رقم 3,شيعي,590,350,11,4,339
قرى صيدا,الصرفند ,التكميلية الرسمية - المبنى الجديد - غرفة رقم 4,شيعي,0,0,0,0,0
قرى صيدا,الصرفند ,التكميلية الرسمية - المبنى الجديد - غرفة رقم 5,شيعي,604,358,18,6,340
قرى صيدا,الصرفند ,التكميلية الرسمية - المبنى الجديد - غرفة رقم 6,شيعي,610,331,5,5,326
قرى صيدا,الصرفند ,التكميلية الرسمية - المبنى الجديد - غرفة رقم 7,شيعي,602,328,8,1,320
قرى صيدا,الصرفند ,ثانوية الصرفند الرسمية - غرفة رقم 1,شيعي,559,342,5,1,337
قرى صيدا,الصرفند ,ثانوية الصرفند الرسمية - غرفة رقم 2,شيعي,579,370,29,6,341
قرى صيدا,الصرفند ,ثانوية الصرفند الرسمية - غرفة رقم 3,شيعي,550,333,6,4,327
قرى صيدا,الصرفند ,ثانوية الصرفند الرسمية - غرفة رقم 4,شيعي,565,331,5,3,326
قرى صيدا,الصرفند ,ثانوية الصرفند الرسمية - غرفة رقم 5,شيعي,566,352,8,6,344
قرى صيدا,الصرفند ,ثانوية الصرفند الرسمية - غرفة رقم 6,شيعي,555,318,10,3,308
قرى صيدا,الصرفند ,ثانوية الصرفند الرسمية - غرفة رقم 7,شيعي,545,323,5,0,318
قرى صيدا,الغازية ,ثانوية الغازية الرسمية - المبنى الجديد - غرفة رقم 1,شيعي,588,345,11,5,334
قرى صيدا,الغازية ,ثانوية الغازية الرسمية - المبنى الجديد - غرفة رقم 10,شيعي,598,304,5,4,299
قرى صيدا,الغازية ,ثانوية الغازية الرسمية - المبنى الجديد - غرفة رقم 11,شيعي,621,359,11,3,348
قرى صيدا,الغازية ,ثانوية الغازية الرسمية - المبنى الجديد - غرفة رقم 12,شيعي,587,337,6,5,331
قرى صيدا,الغازية ,ثانوية الغازية الرسمية - المبنى الجديد - غرفة رقم 13,شيعي,611,331,12,5,319
قرى صيدا,الغازية ,ثانوية الغازية الرسمية - المبنى الجديد - غرفة رقم 2,شيعي,591,321,5,2,316
قرى صيدا,الغازية ,ثانوية الغازية الرسمية - المبنى الجديد - غرفة رقم 3,شيعي,588,306,5,6,301
قرى صيدا,الغازية ,ثانوية الغازية الرسمية - المبنى الجديد - غرفة رقم 4,شيعي,572,332,6,3,326
قرى صيدا,الغازية ,ثانوية الغازية الرسمية - المبنى الجديد - غرفة رقم 5,شيعي,619,373,5,4,368
قرى صيدا,الغازية ,ثانوية الغازية الرسمية - المبنى الجديد - غرفة رقم 6,شيعي,627,360,8,2,352
قرى صيدا,الغازية ,ثانوية الغازية الرسمية - المبنى الجديد - غرفة رقم 7,شيعي,665,352,6,7,346
قرى صيدا,الغازية ,ثانوية الغازية الرسمية - المبنى الجديد - غرفة رقم 8,شيعي,588,337,11,4,326
قرى صيدا,الغازية ,ثانوية الغازية الرسمية - المبنى الجديد - غرفة رقم 9,شيعي,611,299,4,1,295
قرى صيدا,القرية ,المدرسة الرسمية - غرفة رقم 1,ماروني,607,244,20,12,224
قرى صيدا,القرية ,المدرسة الرسمية - غرفة رقم 2,ماروني,609,272,10,9,262
قرى صيدا,القرية ,المدرسة الرسمية - غرفة رقم 3,مسيحي,604,220,8,7,212
قرى صيدا,القنيطرة ,النادي الحسيني - غرفة رقم 1,شيعي,538,384,0,1,384
قرى صيدا,اللوبيه ,المدرسة الرسمية - غرفة رقم 1,شيعي,531,287,10,6,277
قرى صيدا,اللوبيه ,المدرسة الرسمية - غرفة رقم 2,شيعي,477,291,10,2,281
قرى صيدا,المروانية ,التكميلية المختلطة - غرفة رقم 1,شيعي,633,417,14,5,403
قرى صيدا,المروانية ,التكميلية المختلطة - غرفة رقم 2,شيعي,628,347,8,11,339
قرى صيدا,المروانية ,التكميلية المختلطة - غرفة رقم 3,شيعي,657,322,9,6,313
قرى صيدا,المروانية ,التكميلية المختلطة - غرفة رقم 4,شيعي,628,372,4,3,368
قرى صيدا,المروانية ,التكميلية المختلطة - غرفة رقم 5,شيعي,618,335,2,0,333
قرى صيدا,المروانية ,التكميلية المختلطة - غرفة رقم 6,شيعي,616,310,6,5,304
قرى صيدا,المعمرية ,الثانوية الرسمية - غرفة رقم 1,مسيحي,628,209,4,5,205
قرى صيدا,المعمرية ,الثانوية الرسمية - غرفة رقم 2,مسيحي,640,184,2,6,182
قرى صيدا,المية ومية ,المدرسة الرسمية - غرفة رقم 1,روم كاثوليك,610,160,4,2,156
قرى صيدا,المية ومية ,المدرسة الرسمية - غرفة رقم 2,روم كاثوليك,617,141,3,2,138
قرى صيدا,المية ومية ,المدرسة الرسمية - غرفة رقم 3,روم كاثوليك,581,159,3,3,156
قرى صيدا,المية ومية ,المدرسة الرسمية - غرفة رقم 4,روم كاثوليك,573,159,9,2,150
قرى صيدا,المية ومية ,المدرسة الرسمية - غرفة رقم 5,مسيحي,568,66,2,1,64
قرى صيدا,النجارية ,المدرسة الرسمية - غرفة رقم 1,سني,595,358,18,20,340
قرى صيدا,النجارية ,المدرسة الرسمية - غرفة رقم 2,شيعي,537,301,4,4,297
قرى صيدا,النجارية ,المدرسة الرسمية - غرفة رقم 3,شيعي,536,303,2,4,301
قرى صيدا,الهلالية ,القاعة العامة المستحدثة - غرفة رقم 1,مسيحي,412,87,1,2,86
قرى صيدا,الهلالية ,القاعة العامة المستحدثة - غرفة رقم 2,مسيحي,424,74,3,2,71
قرى صيدا,انصاريه ,المدرسة الرسمية - غرفة رقم 1,شيعي,715,446,5,7,441
قرى صيدا,انصاريه ,المدرسة الرسمية - غرفة رقم 2,شيعي,654,396,3,7,393
قرى صيدا,انصاريه ,المدرسة الرسمية - غرفة رقم 3,شيعي,650,410,8,2,402
قرى صيدا,انصاريه ,المدرسة الرسمية - غرفة رقم 4,شيعي,700,434,1,3,433
قرى صيدا,برتي ,مركز البلدية - غرفة رقم 1,مسيحي,550,185,12,1,173
قرى صيدا,برتي ,مركز البلدية - غرفة رقم 2,مسيحي,581,187,9,2,178
قرى صيدا,بقسطه ,بهو الكنيسة - غرفة رقم 1,مسيحي,365,156,8,1,148
قرى صيدا,بنعفول ,المدرسة الرسمية الجديدة - غرفة رقم 1,مختلف,671,358,6,7,352
قرى صيدا,بنعفول ,المدرسة الرسمية الجديدة - غرفة رقم 2,مختلف,673,374,7,2,367
قرى صيدا,تفاحتا ,المدرسة الرسمية - غرفة رقم 1,شيعي,625,294,7,3,287
قرى صيدا,تفاحتا ,المدرسة الرسمية - غرفة رقم 2,شيعي,586,351,7,4,344
قرى صيدا,تفاحتا ,المدرسة الرسمية - غرفة رقم 3,شيعي,595,386,6,1,380
قرى صيدا,تفاحتا ,المدرسة الرسمية - غرفة رقم 4,شيعي,600,325,0,5,325
قرى صيدا,تفاحتا ,النادي الحسيني - غرفة رقم 1,شيعي,628,355,10,3,345
قرى صيدا,تفاحتا ,النادي الحسيني - غرفة رقم 2,شيعي,612,376,4,0,372
قرى صيدا,جنجلايا ,بهو الكنيسة - غرفة رقم 1,ماروني,243,94,1,0,93
قرى صيدا,خرطوم ,مبنى الحسينية - غرفة رقم 1,شيعي,474,244,7,1,237
قرى صيدا,خرطوم ,مبنى الحسينية - غرفة رقم 2,شيعي,487,238,0,7,238
قرى صيدا,خرطوم ,مبنى الحسينية - غرفة رقم 3,شيعي,468,223,0,4,223
قرى صيدا,خزيز ,بهو الكنيسة - غرفة رقم 1,ماروني,177,55,4,1,51
قرى صيدا,درب السيم ,المدرسة الرسمية القديمة المعروفة بثانوية مودرن سكول - غرفة رقم 1,ماروني,566,116,5,6,111
قرى صيدا,درب السيم ,المدرسة الرسمية القديمة المعروفة بثانوية مودرن سكول - غرفة رقم 2,مسيحي,534,133,3,2,130
قرى صيدا,درب السيم ,المدرسة الرسمية القديمة المعروفة بثانوية مودرن سكول - غرفة رقم 3,ماروني,591,145,4,4,141
قرى صيدا,درب السيم ,المدرسة الرسمية القديمة المعروفة بثانوية مودرن سكول - غرفة رقم 4,مسيحي,585,135,5,4,130
قرى صيدا,دول إقليمية,دول إقليمية,مختلف,2875,1560,26,20,1534
قرى صيدا,زغدرايا ,النادي الحسيني - غرفة رقم 1,شيعي,418,258,3,6,255
قرى صيدا,زغدرايا ,النادي الحسيني - غرفة رقم 2,شيعي,424,232,5,7,227
قرى صيدا,زيتا ,المدرسة الرسمية - غرفة رقم 1,مختلف,607,403,10,2,393
قرى صيدا,طنبوريت ,بهو الكنيسة - غرفة رقم 1,ماروني,412,194,7,2,187
قرى صيدا,طنبوريت ,بهو الكنيسة - غرفة رقم 2,ماروني,413,203,4,6,199
قرى صيدا,عبرا ,نادي عبرا - غرفة رقم 1,روم كاثوليك,501,173,3,2,170
قرى صيدا,عبرا ,نادي عبرا - غرفة رقم 2,روم كاثوليك,477,149,7,4,142
قرى صيدا,عبرا ,نادي عبرا - غرفة رقم 3,مسيحي,503,111,5,3,106
قرى صيدا,عدلون ,الثانوية الرسمية الجديدة - قرب مقام النبي ساري - غرفة رقم 1,شيعي,585,330,7,3,323
قرى صيدا,عدلون ,الثانوية الرسمية الجديدة - قرب مقام النبي ساري - غرفة رقم 2,شيعي,602,337,10,1,327
قرى صيدا,عدلون ,الثانوية الرسمية الجديدة - قرب مقام النبي ساري - غرفة رقم 3,شيعي,599,368,4,2,364
قرى صيدا,عدلون ,الثانوية الرسمية الجديدة - قرب مقام النبي ساري - غرفة رقم 4,شيعي,598,368,4,2,364
قرى صيدا,عدلون ,الثانوية الرسمية الجديدة - قرب مقام النبي ساري - غرفة رقم 5,شيعي,597,356,2,4,354
قرى صيدا,عدلون ,المدرسة المتوسطة الرسمية - غرفة رقم 1,شيعي,612,322,14,1,308
قرى صيدا,عدلون ,المدرسة المتوسطة الرسمية - غرفة رقم 2,شيعي,611,308,21,3,287
قرى صيدا,عدلون ,المدرسة المتوسطة الرسمية - غرفة رقم 3,شيعي,601,335,8,8,327
قرى صيدا,عدلون ,المدرسة المتوسطة الرسمية - غرفة رقم 4,شيعي,628,338,16,4,322
قرى صيدا,عدلون ,المدرسة المتوسطة الرسمية - غرفة رقم 5,شيعي,596,313,3,2,310
قرى صيدا,عدوسية ,المدرسة الرسمية - غرفة رقم 1,مسيحي,389,129,10,2,119
قرى صيدا,عدوسية ,المدرسة الرسمية - غرفة رقم 2,مسيحي,398,143,2,4,141
قرى صيدا,عرب الجل ,المدرسة الرسمية - غرفة رقم 1,مختلف,291,182,2,3,180
قرى صيدا,عقتنيت ,المدرسة الرسمية القديمة - غرفة رقم 1,ماروني,451,126,3,8,123
قرى صيدا,عقتنيت ,المدرسة الرسمية القديمة - غرفة رقم 2,ماروني,524,134,5,4,129
قرى صيدا,عنقون ,المبنى البلدي - غرفة رقم 1,مختلف,621,306,6,4,300
قرى صيدا,عنقون ,المبنى البلدي - غرفة رقم 2,مختلف,663,352,4,5,348
قرى صيدا,عنقون ,المبنى البلدي - غرفة رقم 3,مختلف,666,373,3,6,370
قرى صيدا,عنقون ,المبنى البلدي - غرفة رقم 4,مختلف,662,392,1,6,391
قرى صيدا,عنقون ,المبنى البلدي - غرفة رقم 5,مختلف,612,373,7,2,366
قرى صيدا,عين الدلب ,المدرسة الرسمية - غرفة رقم 1,ماروني,560,192,5,11,187
قرى صيدا,عين الدلب ,المدرسة الرسمية - غرفة رقم 2,ماروني,490,180,13,4,167
قرى صيدا,عين الدلب ,المدرسة الرسمية - غرفة رقم 3,مسيحي,586,174,10,3,164
قرى صيدا,غسانية ,المدرسة الرسمية - غرفة رقم 1,شيعي,648,316,0,0,316
قرى صيدا,غسانية ,المدرسة الرسمية - غرفة رقم 2,شيعي,647,345,1,7,344
قرى صيدا,غسانية ,المدرسة الرسمية - غرفة رقم 3,شيعي,661,318,4,3,314
كسروان,ادما والدفنه ,المدرسة الاسقفية الاولى كفرياسين - غرفة رقم 3,ماروني,345,254,7,2,247
كسروان,اغبه ,وقف دير مار يوسف - غرفة رقم 1,ماروني,241,189,0,0,189
كسروان,البوار ,بلدية البوار - غرفة رقم 1,ماروني,477,330,4,0,326
كسروان,البوار ,بلدية البوار - غرفة رقم 2,ماروني,457,297,1,1,296
كسروان,البوار ,بلدية البوار - غرفة رقم 3,ماروني,475,323,2,2,321
كسروان,البوار ,بلدية البوار - غرفة رقم 4,ماروني,534,376,0,0,376
كسروان,الحصين ,مبنى البلدية - غرفة رقم 1,شيعي,410,325,3,0,322
كسروان,السهيله ,دار البلدية - غرفة رقم 1,ماروني,345,223,3,1,220
كسروان,السهيله ,دار البلدية - غرفة رقم 2,ماروني,389,251,5,0,246
كسروان,الصفرا ,المدرسة الرسمية - غرفة رقم 1,ماروني,425,318,7,3,311
كسروان,الصفرا ,المدرسة الرسمية - غرفة رقم 2,ماروني,473,371,12,1,359
كسروان,الصفرا ,المدرسة الرسمية - غرفة رقم 3,ماروني,369,193,0,0,193
كسروان,العذرا ,دار البلدية - غرفة رقم 1,ماروني,605,393,9,0,384
كسروان,العقيبه ,ثانوية مار يوحنا تابعة لوقف مار ضومط - غرفة رقم 1,ماروني,552,457,0,1,457
كسروان,العقيبه ,ثانوية مار يوحنا تابعة لوقف مار ضومط - غرفة رقم 2,ماروني,534,392,6,2,386
كسروان,العقيبه ,ثانوية مار يوحنا تابعة لوقف مار ضومط - غرفة رقم 3,ماروني,595,488,11,1,477
كسروان,العقيبه ,ثانوية مار يوحنا تابعة لوقف مار ضومط - غرفة رقم 4,ماروني,574,425,7,1,418
كسروان,الغينه ,دار البلدية - غرفة رقم 1,ماروني,377,272,1,0,271
كسروان,الغينه ,دار البلدية - غرفة رقم 2,ماروني,378,279,3,1,276
كسروان,القليعات ,دار البلدية - غرفة رقم 1,ماروني,473,304,7,1,297
كسروان,القليعات ,دار البلدية - غرفة رقم 2,ماروني,451,297,4,2,293
كسروان,القليعات ,دار البلدية - غرفة رقم 3,ماروني,489,312,2,1,310
كسروان,القليعات ,دار البلدية - غرفة رقم 4,ماروني,499,319,7,1,312
كسروان,الكفور ,المدرسة التكميلية الرسمية - غرفة رقم 1,ماروني,437,264,0,3,264
كسروان,الكفور ,المدرسة التكميلية الرسمية - غرفة رقم 2,ماروني,413,255,3,1,252
كسروان,الكفور ,المدرسة التكميلية الرسمية - غرفة رقم 3,ماروني,406,241,5,3,236
كسروان,المراديه ,مركز الهاتف - غرفة رقم 1,ماروني,261,181,2,2,179
كسروان,المعيصرة ,مبنى البلدية - غرفة رقم 1,شيعي,389,241,10,1,231
كسروان,المعيصرة ,مبنى البلدية - غرفة رقم 2,شيعي,396,255,2,1,253
كسروان,النموره وكفر جريف ,المدرسة الرسمية - غرفة رقم 1,ماروني,312,259,2,0,257
كسروان,النموره وكفر جريف ,المدرسة الرسمية - غرفة رقم 2,ماروني,365,261,2,1,259
كسروان,بزحل ,المدرسة الرسمية - غرفة رقم 1,ماروني,387,305,14,0,291
كسروان,بزمار ,دير بزمار - غرفة رقم 1,ماروني,286,128,6,1,122
كسروان,بزمار ,دير بزمار - غرفة رقم 2,ماروني,311,131,0,0,131
كسروان,بطحا ,مدرسة مار زخيا - غرفة رقم 1,مسيحي,340,241,1,1,240
كسروان,بطحا ,مدرسة مار زخيا - غرفة رقم 2,مسيحي,344,255,8,1,247
كسروان,بقعاتة عشقوت ,مبنى البلدية - غرفة رقم 1,ماروني,341,276,8,2,268
كسروان,بقعاتة عشقوت ,مبنى البلدية - غرفة رقم 2,ماروني,376,301,8,0,293
كسروان,بقعاتة كنعان ,مبنى الوقف ( مار عبدا) - غرفة رقم 1,ماروني,506,369,3,1,366
كسروان,بقعتوته ,مدرسة سيدة النياح الرسمية - غرفة رقم 1,ماروني,567,419,6,1,413
كسروان,بقعتوته ,مدرسة سيدة النياح الرسمية - غرفة رقم 2,ماروني,548,401,5,2,396
كسروان,بلونه ,المركز الصحي الاجتماعي - غرفة رقم 1,ماروني,328,226,0,2,226
كسروان,بلونه ,المركز الصحي الاجتماعي - غرفة رقم 2,ماروني,332,220,3,0,217
كسروان,جديدة غزير ,مدرسة وميتم مار مخايل في جديدة غزير - غرفة رقم 1,ماروني,352,220,5,0,215
كسروان,جديدة غزير ,مدرسة وميتم مار مخايل في جديدة غزير - غرفة رقم 2,ماروني,399,235,0,1,235
كسروان,جعيتا ,دار البلدية - غرفة رقم 1,ماروني,437,298,3,0,295
كسروان,جعيتا ,دار البلدية - غرفة رقم 2,ماروني,427,295,0,1,295
كسروان,جعيتا ,دار البلدية - غرفة رقم 3,ماروني,433,310,0,1,310
كسروان,جورة الترمس ,دار البلدية - غرفة رقم 1,ماروني,499,329,3,0,326
كسروان,جورة بدران ,غرفة الوقف ( كنيسة مار يوسف) - غرفة رقم 1,ماروني,337,250,0,2,250
كسروان,حارة صخر ,المدرسة الرسمية للصبيان - غرفة رقم 1,ماروني,501,353,0,3,353
كسروان,حارة صخر ,المدرسة الرسمية للصبيان - غرفة رقم 2,ماروني,496,344,9,1,335
كسروان,حارة صخر ,المدرسة الرسمية للصبيان - غرفة رقم 3,ماروني,510,250,3,1,247
كسروان,حارة صخر ,المدرسة الرسمية للصبيان - غرفة رقم 4,ماروني,546,363,9,1,354
كسروان,حارة صخر ,المدرسة الرسمية للصبيان - غرفة رقم 5,ماروني,509,352,7,2,345
كسروان,حارة صخر ,المدرسة الرسمية للصبيان - غرفة رقم 6,ماروني,561,298,2,2,296
كسروان,حارة صخر ,المدرسة الرسمية للصبيان - غرفة رقم 7,مسيحي,569,290,15,3,275
كسروان,حراجل ,مدرسة حراجل الرسمية المتوسطة - غرفة رقم 1,ماروني,557,467,15,2,452
كسروان,حراجل ,مدرسة حراجل الرسمية المتوسطة - غرفة رقم 2,ماروني,559,479,9,0,470
كسروان,حراجل ,مدرسة حراجل الرسمية المتوسطة - غرفة رقم 3,ماروني,553,444,11,0,433
كسروان,حراجل ,مدرسة حراجل الرسمية المتوسطة - غرفة رقم 4,ماروني,574,473,10,2,463
كسروان,حراجل ,مدرسة حراجل الرسمية المتوسطة - غرفة رقم 5,ماروني,548,438,1,1,437
كسروان,حراجل ,مدرسة حراجل الرسمية المتوسطة - غرفة رقم 6,ماروني,562,453,10,1,443
كسروان,حراجل ,مدرسة حراجل الرسمية المتوسطة - غرفة رقم 7,ماروني,519,418,8,1,410
كسروان,حراجل ,مدرسة حراجل الرسمية المتوسطة - غرفة رقم 8,ماروني,433,413,2,2,411
كسروان,حراجل ,مدرسة حراجل الرسمية المتوسطة - غرفة رقم 9,ماروني,511,330,10,1,320
كسروان,حريصا ,دير مار انطونيوس البدواني - غرفة رقم 1,مسيحي,374,197,6,0,191
كسروان,حياطه ,دار البلدية - غرفة رقم 1,ماروني,480,384,0,1,384
كسروان,داريا ,دار البلدية - غرفة رقم 1,ماروني,338,240,2,0,238
كسروان,داريا ,دار البلدية - غرفة رقم 2,ماروني,356,252,5,2,247
كسروان,درعون ,المدرسة الرسمية - غرفة رقم 1,ماروني,505,327,0,2,327
كسروان,درعون ,المدرسة الرسمية - غرفة رقم 2,ماروني,500,350,13,1,337
كسروان,درعون ,المدرسة الرسمية - غرفة رقم 3,ماروني,495,314,17,0,297
كسروان,درعون ,المدرسة الرسمية - غرفة رقم 4,ماروني,500,341,0,0,341
كسروان,درعون ,المدرسة الرسمية - غرفة رقم 5,ماروني,444,164,5,0,159
كسروان,دلبتا ,دار البلدية - غرفة رقم 1,ماروني,473,278,1,0,277
كسروان,دلبتا ,دار البلدية - غرفة رقم 2,ماروني,448,275,5,0,270
كسروان,دلبتا ,دار البلدية - غرفة رقم 3,ماروني,427,144,1,1,143
كسروان,دول إقليمية,دول إقليمية,مختلف,2014,1362,11,3,1351
كسروان,رعشين ,مبنى البلدية - غرفة رقم 1,ماروني,437,356,7,0,349
كسروان,رعشين ,مبنى البلدية - غرفة رقم 2,ماروني,575,422,4,1,418
كسروان,رعشين ,مبنى البلدية - غرفة رقم 3,ماروني,459,344,10,2,334
كسروان,ريفون ,دار البلدية - غرفة رقم 1,ماروني,356,233,2,2,231
كسروان,ريفون ,دار البلدية - غرفة رقم 2,ماروني,366,208,2,2,206
كسروان,ريفون ,مركز البريد - غرفة رقم 1,ماروني,387,214,1,0,213
كسروان,زعيتره ,صالة كنيسة سيدة الدر - غرفة رقم 1,ماروني,364,222,1,0,221
كسروان,زعيتره ,صالة كنيسة سيدة الدر - غرفة رقم 2,ماروني,413,267,4,2,263
كسروان,زوق مصبح ,المدرسة الرسمية (بلدية ذوق مصبح) - غرفة رقم 1,ماروني,476,362,2,1,360
كسروان,زوق مصبح ,المدرسة الرسمية (بلدية ذوق مصبح) - غرفة رقم 2,مسيحي,484,231,4,1,227
كسروان,زوق مصبح ,المدرسة الرسمية (بلدية ذوق مصبح) - غرفة رقم 3,ماروني,497,363,3,1,360
كسروان,زوق مصبح ,المدرسة الرسمية (بلدية ذوق مصبح) - غرفة رقم 4,مسيحي,532,284,2,1,282
كسروان,زوق مكايل ,البيت الحرفي - غرفة رقم 1,ماروني,585,377,1,2,376
كسروان,زوق مكايل ,البيت الحرفي - غرفة رقم 2,ماروني,543,352,13,1,339
كسروان,زوق مكايل ,البيت الحرفي - غرفة رقم 3,ماروني,514,106,1,0,105
كسروان,زوق مكايل ,البيت الحرفي - غرفة رقم 4,ماروني,571,404,7,5,397
كسروان,زوق مكايل ,البيت الحرفي - غرفة رقم 5,ماروني,556,356,9,1,347
كسروان,زوق مكايل ,البيت الحرفي - غرفة رقم 6,ماروني,525,130,5,0,125
كسروان,زوق مكايل ,البيت الحرفي - غرفة رقم 7,مسيحي,525,284,2,1,282
كسروان,زوق مكايل ,البيت الحرفي - غرفة رقم 8,روم كاثوليك,556,275,0,4,275
كسروان,زيتون ,دار البلدية - غرفة رقم 1,مختلف,542,435,6,0,429
كسروان,ساحل علما ,مدرسة مار نهرا - غرفة رقم 1,ماروني,541,406,9,3,397
كسروان,ساحل علما ,مدرسة مار نهرا - غرفة رقم 2,ماروني,547,401,11,2,390
كسروان,ساحل علما ,مدرسة مار نهرا - غرفة رقم 3,ماروني,529,266,10,0,256
كسروان,شحتول ,المدرسة الرسمية - غرفة رقم 1,ماروني,435,313,3,2,310
كسروان,شحتول ,المدرسة الرسمية - غرفة رقم 2,ماروني,470,334,6,2,328
كسروان,شننعير ,دار البلدية - غرفة رقم 1,ماروني,298,150,1,0,149
كسروان,شننعير ,دار البلدية - غرفة رقم 2,ماروني,304,144,0,0,144
كسروان,شوان والعبره ,غرفة في كنيسة سان تريز - غرفة رقم 1,ماروني,347,253,4,0,249
كسروان,صربا ,المدرسة الرسمية شرقي - غرفة رقم 1,أرمن ارثوذكس,556,198,5,0,193
كسروان,صربا ,المدرسة الرسمية شرقي - غرفة رقم 2,ماروني,565,371,4,1,367
كسروان,صربا ,المدرسة الرسمية شرقي - غرفة رقم 3,ماروني,604,363,3,0,360
كسروان,صربا ,المدرسة الرسمية شرقي - غرفة رقم 4,ماروني,557,301,1,0,300
كسروان,صربا ,المدرسة الرسمية شرقي - غرفة رقم 5,مسيحي,550,291,12,1,279
كسروان,صربا ,المدرسة الرسمية غربي - غرفة رقم 1,ماروني,596,366,5,1,361
كسروان,صربا ,المدرسة الرسمية غربي - غرفة رقم 2,ماروني,593,380,4,2,376
كسروان,صربا ,المدرسة الرسمية غربي - غرفة رقم 3,ماروني,593,321,3,1,318
كسروان,صربا ,المدرسة الرسمية غربي - غرفة رقم 4,ماروني,606,310,9,0,301
كسروان,صربا ,المدرسة الرسمية غربي - غرفة رقم 5,مسيحي,638,403,2,0,401
كسروان,طبرجا ,دار البلدية - غرفة رقم 1,ماروني,382,261,1,1,260
كسروان,طبرجا ,دار البلدية - غرفة رقم 2,ماروني,427,292,1,1,291
كسروان,عجلتون ,مهنية عجلتون - غرفة رقم 1,ماروني,537,327,0,2,327
كسروان,عجلتون ,مهنية عجلتون - غرفة رقم 2,ماروني,523,309,0,0,309
كسروان,عجلتون ,مهنية عجلتون - غرفة رقم 3,ماروني,532,359,3,0,356
كسروان,عجلتون ,مهنية عجلتون - غرفة رقم 4,ماروني,526,316,1,1,315
كسروان,عجلتون ,مهنية عجلتون - غرفة رقم 5,مسيحي,520,252,4,1,248
كسروان,عرمون ,مركز البلدية - غرفة رقم 1,ماروني,369,233,0,1,233
كسروان,عرمون ,مركز البلدية - غرفة رقم 2,ماروني,390,236,1,0,235
كسروان,عشقوت ,مدرسة اسكندر رزق الرسمية - غرفة رقم 1,ماروني,508,392,5,0,387
كسروان,عشقوت ,مدرسة اسكندر رزق الرسمية - غرفة رقم 2,ماروني,504,366,7,2,359
كسروان,عشقوت ,مدرسة اسكندر رزق الرسمية - غرفة رقم 3,ماروني,518,381,7,0,374
كسروان,عشقوت ,مدرسة اسكندر رزق الرسمية - غرفة رقم 4,ماروني,490,344,6,0,338
كسروان,عشقوت ,مدرسة اسكندر رزق الرسمية - غرفة رقم 5,ماروني,510,314,4,1,310
كسروان,عين الدلبه ,صالون الكنيسة - غرفة رقم 1,ماروني,489,379,8,0,371
كسروان,عين الريحانه ,دار البلدية - غرفة رقم 1,ماروني,529,340,14,0,326
كسروان,عينطوره ,دار البلدية - غرفة رقم 1,ماروني,428,264,1,0,263
كسروان,عينطوره ,دار البلدية - غرفة رقم 2,ماروني,438,268,5,1,263
كسروان,غادير ,ثانوية جورج افرام الرسمية - غرفة رقم 1,ماروني,557,381,3,0,378
كسروان,غادير ,ثانوية جورج افرام الرسمية - غرفة رقم 10,مسيحي,581,290,5,1,285
كسروان,غادير ,ثانوية جورج افرام الرسمية - غرفة رقم 2,ماروني,576,405,2,0,403
كسروان,غادير ,ثانوية جورج افرام الرسمية - غرفة رقم 3,ماروني,542,322,3,1,319
كسروان,غادير ,ثانوية جورج افرام الرسمية - غرفة رقم 4,ماروني,526,235,0,0,235
كسروان,غادير ,ثانوية جورج افرام الرسمية - غرفة رقم 5,ماروني,571,378,8,0,370
كسروان,غادير ,ثانوية جورج افرام الرسمية - غرفة رقم 6,ماروني,577,410,16,0,394
كسروان,غادير ,ثانوية جورج افرام الرسمية - غرفة رقم 7,ماروني,569,327,7,1,320
كسروان,غادير ,ثانوية جورج افرام الرسمية - غرفة رقم 8,ماروني,575,250,2,0,248
كسروان,غادير ,ثانوية جورج افرام الرسمية - غرفة رقم 9,مسيحي,394,189,4,0,185
كسروان,غباله ,صالة كنيسة مار سركيس وباخوس – غبالة - غرفة رقم 1,ماروني,520,386,0,0,386
كسروان,غباله ,صالة كنيسة مار سركيس وباخوس – غبالة - غرفة رقم 2,ماروني,545,385,14,3,371
كسروان,غباله ,صالة كنيسة مار سركيس وباخوس – غبالة - غرفة رقم 3,ماروني,527,373,6,0,367
كسروان,غدراس ,غرفة وقف مار ساسين - غرفة رقم 1,ماروني,320,256,0,1,256
كسروان,غزير الجامع ,المدرسة الثانوية - غرفة رقم 1,ماروني,504,307,3,1,304
كسروان,غزير الجامع ,المدرسة الثانوية - غرفة رقم 2,ماروني,502,296,6,1,290
كسروان,غزير الجامع ,المدرسة الثانوية - غرفة رقم 3,ارمن  ,476,136,0,0,136
كسروان,غزير الجامع ,المدرسة الثانوية - غرفة رقم 4,ماروني,478,145,1,0,144
كسروان,غزير الجامع ,المدرسة الثانوية - غرفة رقم 5,ماروني,493,293,7,1,286
كسروان,غزير الجامع ,المدرسة الثانوية - غرفة رقم 6,ماروني,464,295,3,1,292
كسروان,غزير الجامع ,المدرسة الثانوية - غرفة رقم 7,ماروني,500,162,6,2,156
كسروان,غزير القناة ,مدرسة مار فرنسيس – ساحة غزير - غرفة رقم 1,ماروني,411,252,2,0,250
كسروان,غزير القناة ,مدرسة مار فرنسيس – ساحة غزير - غرفة رقم 2,ماروني,415,264,2,2,262
كسروان,غزير القناة ,مدرسة مار فرنسيس – ساحة غزير - غرفة رقم 3,ماروني,402,220,1,0,219
كسروان,غزير المعاملتين ,مدرسة مار فرنسيس – ساحة غزير - غرفة رقم 4,ماروني,399,229,8,1,221
كسروان,غوسطا ,الثانوية الرسمية - غرفة رقم 1,ماروني,486,360,6,0,354
كسروان,غوسطا ,الثانوية الرسمية - غرفة رقم 2,ماروني,493,350,6,0,344
كسروان,غوسطا ,الثانوية الرسمية - غرفة رقم 3,ماروني,488,284,8,1,276
كسروان,غوسطا ,الثانوية الرسمية - غرفة رقم 4,ماروني,526,362,1,0,361
كسروان,غوسطا ,الثانوية الرسمية - غرفة رقم 5,ماروني,534,361,2,0,359
كسروان,غوسطا ,الثانوية الرسمية - غرفة رقم 6,ماروني,498,275,4,1,271
كسروان,فاريا ,مدرسة فاريا المتوسطة الرسمية ( وقف مار شليطا) - غرفة رقم 1,ماروني,537,419,10,2,409
كسروان,فاريا ,مدرسة فاريا المتوسطة الرسمية ( وقف مار شليطا) - غرفة رقم 2,ماروني,507,416,5,1,411
كسروان,فاريا ,مدرسة فاريا المتوسطة الرسمية ( وقف مار شليطا) - غرفة رقم 3,ماروني,549,431,19,2,412
كسروان,فاريا ,مدرسة فاريا المتوسطة الرسمية ( وقف مار شليطا) - غرفة رقم 4,ماروني,531,424,4,2,420
كسروان,فتقا ,دار البلدية - غرفة رقم 1,ماروني,514,357,7,1,350
كسروان,فيطرون ,دار البلدية - غرفة رقم 1,ماروني,386,386,2,1,384
كسروان,فيطرون ,دار البلدية - غرفة رقم 2,ماروني,470,351,13,0,338
كسروان,فيطرون ,دار البلدية - غرفة رقم 3,ماروني,449,282,0,1,282
كسروان,كسروان موظفون ,سراي جونيه - غرفة رقم 1,مختلف,138,133,3,2,130
كسروان,كفرتيه ,صالون كنيسة سيدة النجاة - غرفة رقم 1,ماروني,269,149,1,1,148
كسروان,كفردبيان ,مدرسة فريد سلامة الرسمية - غرفة رقم 1,ماروني,528,407,4,1,403
كسروان,كفردبيان ,مدرسة فريد سلامة الرسمية - غرفة رقم 2,ماروني,526,409,45,1,364
كسروان,كفردبيان ,مدرسة فريد سلامة الرسمية - غرفة رقم 3,ماروني,522,420,22,3,398
كسروان,كفردبيان ,مدرسة فريد سلامة الرسمية - غرفة رقم 4,ماروني,531,365,15,2,350
كسروان,كفردبيان ,مدرسة فريد سلامة الرسمية - غرفة رقم 5,ماروني,561,415,16,0,399
كسروان,كفردبيان ,مدرسة فريد سلامة الرسمية - غرفة رقم 6,ماروني,550,433,12,2,421
كسروان,كفردبيان ,مدرسة فريد سلامة الرسمية - غرفة رقم 7,ماروني,544,400,2,3,398
كسروان,كفردبيان ,مدرسة فريد سلامة الرسمية - غرفة رقم 8,ماروني,562,377,0,0,377
كسروان,كفرياسين ,المدرسة الاسقفية الاولى كفرياسين - غرفة رقم 1,ماروني,409,278,2,1,276
كسروان,كفرياسين ,المدرسة الاسقفية الاولى كفرياسين - غرفة رقم 2,ماروني,408,287,4,2,283
كسروان,معراب ,غرفة الوقف - غرفة رقم 1,ماروني,251,161,0,2,161
كسروان,ميروبا ,المدرسة الرسمية - غرفة رقم 1,ماروني,475,353,1,3,352
كسروان,ميروبا ,المدرسة الرسمية - غرفة رقم 2,ماروني,471,312,14,3,298
كسروان,ميروبا ,المدرسة الرسمية - غرفة رقم 3,ماروني,479,348,1,0,347
كسروان,ميروبا ,المدرسة الرسمية - غرفة رقم 4,ماروني,520,351,2,2,349
كسروان,نهر الذهب ,المدرسة الرسمية - غرفة رقم 1,ماروني,441,368,4,0,364
كسروان,هرهريا والقطين ,صالون كنيسة مار شربل القطين - غرفة رقم 1,ماروني,411,311,1,5,310
كسروان,وطى الجوز ,مبنى البلدية - غرفة رقم 1,ماروني,321,246,0,1,246
كسروان,وطى الجوز ,مبنى البلدية - غرفة رقم 2,ماروني,316,249,3,1,246
كسروان,يحشوش ,المدرسة الرسمية الجديدة - غرفة رقم 1,ماروني,576,364,21,0,343
كسروان,يحشوش ,المدرسة الرسمية الجديدة - غرفة رقم 2,ماروني,546,324,3,2,321
كسروان,يحشوش ,المدرسة الرسمية الجديدة - غرفة رقم 3,ماروني,579,386,4,1,382
كسروان,يحشوش ,المدرسة الرسمية الجديدة - غرفة رقم 4,ماروني,576,337,10,1,327
مرجعيون,ابل السقي ,المدرسة الرسمية القديمة - غرفة رقم 1,مختلف,534,128,3,3,125
مرجعيون,ابل السقي ,المدرسة الرسمية القديمة - غرفة رقم 2,درزي,503,261,2,7,259
مرجعيون,ابل السقي ,المدرسة الرسمية القديمة - غرفة رقم 3,روم ارثوذكس,539,130,0,0,130
مرجعيون,ابل السقي ,المدرسة الرسمية القديمة - غرفة رقم 4,درزي,507,283,5,1,278
مرجعيون,ابل السقي ,المدرسة الرسمية القديمة - غرفة رقم 5,مختلف,497,128,1,3,127
مرجعيون,الجديدة حي السراي ,المدرسة المهنية الرسمية - غرفة رقم 1,مسيحي,525,132,1,0,131
مرجعيون,الجديدة حي السراي ,المدرسة المهنية الرسمية - غرفة رقم 2,مسيحي,599,147,2,1,145
مرجعيون,الجديدة حي السراي ,المدرسة المهنية الرسمية - غرفة رقم 3,مسيحي,567,174,4,2,170
مرجعيون,الجديدة حي العيون ,المدرسة المهنية الرسمية - غرفة رقم 4,مسيحي,644,202,2,1,200
مرجعيون,الجديدة حي العيون ,المدرسة المهنية الرسمية - غرفة رقم 5,مسيحي,607,168,0,1,168
مرجعيون,الجديدة حي العيون ,المدرسة المهنية الرسمية - غرفة رقم 6,مختلف,594,190,3,0,187
مرجعيون,الجديدة حي القلعة ,المدرسة المتوسطة الرسمية - غرفة رقم 4,مسيحي,463,127,1,2,126
مرجعيون,الجديدة حي القلعة ,المدرسة المتوسطة الرسمية - غرفة رقم 5,مختلف,474,111,0,0,111
مرجعيون,الجديدة حي القلعة ,المدرسة المتوسطة الرسمية - غرفة رقم 6,مختلف,434,101,1,0,100
مرجعيون,الجديدة حي المدارس ,المدرسة المتوسطة الرسمية - غرفة رقم 1,مختلف,599,217,2,1,215
مرجعيون,الجديدة حي المدارس ,المدرسة المتوسطة الرسمية - غرفة رقم 2,مختلف,611,174,1,0,173
مرجعيون,الجديدة حي المدارس ,المدرسة المتوسطة الرسمية - غرفة رقم 3,مختلف,610,210,2,0,208
مرجعيون,الخيام جنوبي ,مدرسة علي حسين عبدالله المتوسطة الرسمية - غرفة رقم 10,شيعي,588,329,4,2,325
مرجعيون,الخيام جنوبي ,مدرسة علي حسين عبدالله المتوسطة الرسمية - غرفة رقم 11,شيعي,578,270,2,3,268
مرجعيون,الخيام جنوبي ,مدرسة علي حسين عبدالله المتوسطة الرسمية - غرفة رقم 12,شيعي,598,268,2,0,266
مرجعيون,الخيام جنوبي ,مدرسة علي حسين عبدالله المتوسطة الرسمية - غرفة رقم 13,شيعي,574,261,0,1,261
مرجعيون,الخيام جنوبي ,مدرسة علي حسين عبدالله المتوسطة الرسمية - غرفة رقم 14,شيعي,590,342,2,0,340
مرجعيون,الخيام جنوبي ,مدرسة علي حسين عبدالله المتوسطة الرسمية - غرفة رقم 15,شيعي,606,302,0,2,302
مرجعيون,الخيام جنوبي ,مدرسة علي حسين عبدالله المتوسطة الرسمية - غرفة رقم 16,شيعي,535,255,1,0,254
مرجعيون,الخيام جنوبي ,مدرسة علي حسين عبدالله المتوسطة الرسمية - غرفة رقم 9,شيعي,579,262,1,2,261
مرجعيون,الخيام شرقي ,المدرسة المهنية الرسمية (الثانوية الرسمية حاليا) - غرفة رقم 1,شيعي,589,265,1,2,264
مرجعيون,الخيام شرقي ,المدرسة المهنية الرسمية (الثانوية الرسمية حاليا) - غرفة رقم 2,شيعي,615,340,1,1,339
مرجعيون,الخيام شرقي ,المدرسة المهنية الرسمية (الثانوية الرسمية حاليا) - غرفة رقم 3,شيعي,608,236,0,2,236
مرجعيون,الخيام شرقي ,المدرسة المهنية الرسمية (الثانوية الرسمية حاليا) - غرفة رقم 4,شيعي,614,309,1,3,308
مرجعيون,الخيام شرقي ,المدرسة المهنية الرسمية (الثانوية الرسمية حاليا) - غرفة رقم 5,شيعي,641,289,2,2,287
مرجعيون,الخيام شرقي ,المدرسة المهنية الرسمية (الثانوية الرسمية حاليا) - غرفة رقم 6,شيعي,650,365,6,2,359
مرجعيون,الخيام شرقي ,المدرسة المهنية الرسمية (الثانوية الرسمية حاليا) - غرفة رقم 7,شيعي,657,271,1,3,270
مرجعيون,الخيام شرقي ,المدرسة المهنية الرسمية (الثانوية الرسمية حاليا) - غرفة رقم 8,شيعي,635,328,2,0,326
مرجعيون,الخيام شمالي ,المدرسة الابتدائية الرسمية - غرفة رقم 1,شيعي,555,275,1,4,274
مرجعيون,الخيام شمالي ,المدرسة الابتدائية الرسمية - غرفة رقم 2,شيعي,572,314,5,5,309
مرجعيون,الخيام شمالي ,المدرسة الابتدائية الرسمية - غرفة رقم 3,شيعي,540,300,1,2,299
مرجعيون,الخيام شمالي ,المدرسة الابتدائية الرسمية - غرفة رقم 4,روم ارثوذكس,515,91,0,0,91
مرجعيون,الخيام شمالي ,المدرسة الابتدائية الرسمية - غرفة رقم 5,مختلف,520,92,1,0,91
مرجعيون,الخيام غربي ,مدرسة علي حسين عبد الله المتوسطة الرسمية - غرفة رقم 1,شيعي,593,220,2,0,218
مرجعيون,الخيام غربي ,مدرسة علي حسين عبد الله المتوسطة الرسمية - غرفة رقم 2,شيعي,574,265,4,0,261
مرجعيون,الخيام غربي ,مدرسة علي حسين عبد الله المتوسطة الرسمية - غرفة رقم 3,شيعي,634,290,3,3,287
مرجعيون,الخيام غربي ,مدرسة علي حسين عبد الله المتوسطة الرسمية - غرفة رقم 4,شيعي,615,294,4,3,290
مرجعيون,الخيام غربي ,مدرسة علي حسين عبد الله المتوسطة الرسمية - غرفة رقم 5,شيعي,592,235,2,0,233
مرجعيون,الخيام غربي ,مدرسة علي حسين عبد الله المتوسطة الرسمية - غرفة رقم 6,شيعي,621,273,14,1,259
مرجعيون,الخيام غربي ,مدرسة علي حسين عبد الله المتوسطة الرسمية - غرفة رقم 7,شيعي,686,320,3,1,317
مرجعيون,الخيام غربي ,مدرسة علي حسين عبد الله المتوسطة الرسمية - غرفة رقم 8,شيعي,682,328,6,1,322
مرجعيون,الطيبه ,مدرسة الطيبه المتوسطة الرسمية - غرفة رقم 1,شيعي,665,360,1,5,359
مرجعيون,الطيبه ,مدرسة الطيبه المتوسطة الرسمية - غرفة رقم 10,شيعي,651,344,1,2,343
مرجعيون,الطيبه ,مدرسة الطيبه المتوسطة الرسمية - غرفة رقم 11,شيعي,621,314,4,4,310
مرجعيون,الطيبه ,مدرسة الطيبه المتوسطة الرسمية - غرفة رقم 12,شيعي,646,340,4,1,336
مرجعيون,الطيبه ,مدرسة الطيبه المتوسطة الرسمية - غرفة رقم 13,شيعي,630,318,5,1,313
مرجعيون,الطيبه ,مدرسة الطيبه المتوسطة الرسمية - غرفة رقم 2,شيعي,675,375,5,3,370
مرجعيون,الطيبه ,مدرسة الطيبه المتوسطة الرسمية - غرفة رقم 3,شيعي,639,354,4,0,350
مرجعيون,الطيبه ,مدرسة الطيبه المتوسطة الرسمية - غرفة رقم 4,شيعي,643,310,1,2,309
مرجعيون,الطيبه ,مدرسة الطيبه المتوسطة الرسمية - غرفة رقم 5,شيعي,654,346,7,1,339
مرجعيون,الطيبه ,مدرسة الطيبه المتوسطة الرسمية - غرفة رقم 6,شيعي,609,307,8,4,299
مرجعيون,الطيبه ,مدرسة الطيبه المتوسطة الرسمية - غرفة رقم 7,شيعي,653,373,1,2,372
مرجعيون,الطيبه ,مدرسة الطيبه المتوسطة الرسمية - غرفة رقم 8,شيعي,666,369,4,2,365
مرجعيون,الطيبه ,مدرسة الطيبه المتوسطة الرسمية - غرفة رقم 9,شيعي,630,356,7,2,349
مرجعيون,القصير ,النادي الحسيني - غرفة رقم 1,شيعي,205,113,0,1,113
مرجعيون,القليعه ,المتوسطة الرسمية - غرفة رقم 1,ماروني,564,228,10,5,218
مرجعيون,القليعه ,المتوسطة الرسمية - غرفة رقم 2,ماروني,543,163,0,1,163
مرجعيون,القليعه ,المتوسطة الرسمية - غرفة رقم 3,ماروني,586,199,5,3,194
مرجعيون,القليعه ,المتوسطة الرسمية - غرفة رقم 4,ماروني,568,242,1,4,241
مرجعيون,القليعه ,المتوسطة الرسمية - غرفة رقم 5,ماروني,552,190,5,5,185
مرجعيون,القليعه ,المتوسطة الرسمية - غرفة رقم 6,ماروني,586,237,2,4,235
مرجعيون,القليعه ,المتوسطة الرسمية - غرفة رقم 7,ماروني,522,121,0,1,121
مرجعيون,الوزاني ,المدرسة الرسمية - غرفة رقم 1,مسلم,463,234,16,4,218
مرجعيون,برج الملوك ,نادي الشعله - غرفة رقم 1,مسيحي,571,177,0,1,177
مرجعيون,برج الملوك ,نادي الشعله - غرفة رقم 2,مسيحي,592,211,3,1,208
مرجعيون,بلاط ,المدرسة المتوسطة الرسمية - غرفة رقم 1,شيعي,608,321,1,1,320
مرجعيون,بلاط ,المدرسة المتوسطة الرسمية - غرفة رقم 2,مختلف,623,282,6,3,276
مرجعيون,بلاط ,المدرسة المتوسطة الرسمية - غرفة رقم 3,شيعي,643,373,3,5,370
مرجعيون,بلاط ,المدرسة المتوسطة الرسمية - غرفة رقم 4,مختلف,651,308,3,4,305
مرجعيون,بليدا ,مدرسة بليدا المتوسطه الرسمية البناء الجديد - غرفة رقم 1,شيعي,670,290,1,3,289
مرجعيون,بليدا ,مدرسة بليدا المتوسطه الرسمية البناء الجديد - غرفة رقم 2,شيعي,650,241,6,1,235
مرجعيون,بليدا ,مدرسة بليدا المتوسطه الرسمية البناء الجديد - غرفة رقم 3,شيعي,692,257,3,0,254
مرجعيون,بليدا ,مدرسة بليدا المتوسطه الرسمية البناء الجديد - غرفة رقم 4,شيعي,676,275,3,3,272
مرجعيون,بليدا ,مدرسة بليدا المتوسطه الرسمية البناء الجديد - غرفة رقم 5,شيعي,614,317,2,1,315
مرجعيون,بليدا ,مدرسة بليدا المتوسطه الرسمية البناء الجديد - غرفة رقم 6,شيعي,633,281,1,1,280
مرجعيون,بليدا ,مدرسة بليدا المتوسطه الرسمية البناء الجديد - غرفة رقم 7,شيعي,654,286,3,0,283
مرجعيون,بليدا ,مدرسة بليدا المتوسطه الرسمية البناء الجديد - غرفة رقم 8,شيعي,640,264,2,3,262
مرجعيون,بليدا ,مدرسة بليدا المتوسطه الرسمية البناء الجديد - غرفة رقم 9,شيعي,666,278,1,0,277
مرجعيون,بني حيان ,مدرسة بني حيان الرسمية - غرفة رقم 1,شيعي,498,313,0,0,313
مرجعيون,بني حيان ,مدرسة بني حيان الرسمية - غرفة رقم 2,شيعي,517,344,1,1,343
مرجعيون,بني حيان ,مدرسة بني حيان الرسمية - غرفة رقم 3,شيعي,510,313,3,4,310
مرجعيون,بويضة ,كنيسة مار الياس - غرفة رقم 1,مختلف,254,98,0,0,98
مرجعيون,تولين ,الثانوية الرسمية الجديدة - غرفة رقم 1,شيعي,581,293,4,0,289
مرجعيون,تولين ,الثانوية الرسمية الجديدة - غرفة رقم 2,شيعي,568,314,6,2,308
مرجعيون,تولين ,الثانوية الرسمية الجديدة - غرفة رقم 3,شيعي,577,355,6,1,349
مرجعيون,تولين ,الثانوية الرسمية الجديدة - غرفة رقم 4,شيعي,560,370,3,1,367
مرجعيون,حولا ,المدرسة التكميلية الرسمية الجديدة - غرفة رقم 1,شيعي,620,327,1,1,326
مرجعيون,حولا ,المدرسة التكميلية الرسمية الجديدة - غرفة رقم 10,شيعي,640,344,3,0,341
مرجعيون,حولا ,المدرسة التكميلية الرسمية الجديدة - غرفة رقم 2,شيعي,650,377,12,2,365
مرجعيون,حولا ,المدرسة التكميلية الرسمية الجديدة - غرفة رقم 3,شيعي,641,364,3,2,361
مرجعيون,حولا ,المدرسة التكميلية الرسمية الجديدة - غرفة رقم 4,شيعي,652,384,7,5,377
مرجعيون,حولا ,المدرسة التكميلية الرسمية الجديدة - غرفة رقم 5,شيعي,602,309,3,3,306
مرجعيون,حولا ,المدرسة التكميلية الرسمية الجديدة - غرفة رقم 6,شيعي,636,365,9,2,356
مرجعيون,حولا ,المدرسة التكميلية الرسمية الجديدة - غرفة رقم 7,شيعي,635,385,9,3,376
مرجعيون,حولا ,المدرسة التكميلية الرسمية الجديدة - غرفة رقم 8,شيعي,663,417,26,2,391
مرجعيون,حولا ,المدرسة التكميلية الرسمية الجديدة - غرفة رقم 9,شيعي,672,405,12,3,393
مرجعيون,دبين ,المدرسة المتوسطة الرسمية - غرفة رقم 1,شيعي,553,252,1,1,251
مرجعيون,دبين ,المدرسة المتوسطة الرسمية - غرفة رقم 2,مختلف,564,231,2,0,229
مرجعيون,دبين ,المدرسة المتوسطة الرسمية - غرفة رقم 3,شيعي,578,304,1,2,303
مرجعيون,دبين ,المدرسة المتوسطة الرسمية - غرفة رقم 4,مختلف,584,266,2,2,264
مرجعيون,دول إقليمية,دول إقليمية,مختلف,3007,1637,34,11,1603
مرجعيون,دير سريان ,المدرسة الابتدائية الرسمية - غرفة رقم 1,شيعي,677,390,6,4,384
مرجعيون,دير سريان ,المدرسة الابتدائية الرسمية - غرفة رقم 2,شيعي,689,440,7,4,433
مرجعيون,دير ميماس ,المدرسة الابتدائية - غرفة رقم 1,روم ارثوذكس,567,191,5,0,186
مرجعيون,دير ميماس ,المدرسة الابتدائية - غرفة رقم 2,مختلف,562,156,0,0,156
مرجعيون,دير ميماس ,المدرسة الابتدائية - غرفة رقم 3,روم ارثوذكس,550,175,5,2,170
مرجعيون,دير ميماس ,المدرسة الابتدائية - غرفة رقم 4,مختلف,549,175,8,4,167
مرجعيون,دير ميماس ,المدرسة الابتدائية - غرفة رقم 5,مختلف,534,105,1,1,104
مرجعيون,رب ثلاثين ,المدرسة الابتدائية الرسمية - غرفة رقم 1,شيعي,583,358,0,2,358
مرجعيون,رب ثلاثين ,المدرسة الابتدائية الرسمية - غرفة رقم 2,شيعي,559,313,7,1,306
مرجعيون,رب ثلاثين ,المدرسة الابتدائية الرسمية - غرفة رقم 3,شيعي,602,365,2,3,363
مرجعيون,رب ثلاثين ,المدرسة الابتدائية الرسمية - غرفة رقم 4,شيعي,585,331,1,2,330
مرجعيون,سرده والعمره ,مكتب مطران مرجعيون في البلدة - غرفة رقم 1,مختلف,462,215,8,0,207
مرجعيون,صوانه ,المدرسة الرسمية - غرفة رقم 1,شيعي,585,394,5,2,389
مرجعيون,صوانه ,المدرسة الرسمية - غرفة رقم 2,شيعي,593,418,4,1,414
مرجعيون,صوانه ,المدرسة الرسمية - غرفة رقم 3,شيعي,592,380,4,5,376
مرجعيون,طلوسه ,المدرسة الابتدائية - غرفة رقم 1,شيعي,663,371,4,6,367
مرجعيون,طلوسه ,المدرسة الابتدائية - غرفة رقم 2,شيعي,671,407,5,2,402
مرجعيون,طلوسه ,المدرسة الابتدائية - غرفة رقم 3,شيعي,615,372,0,2,372
مرجعيون,عدشيت ,المتوسطة الرسمية - غرفة رقم 1,شيعي,410,238,1,4,237
مرجعيون,عدشيت ,المتوسطة الرسمية - غرفة رقم 2,شيعي,358,237,3,3,234
مرجعيون,عديسه ,المدرسة المتوسطة الرسمية - غرفة رقم 1,شيعي,634,363,15,6,348
مرجعيون,عديسه ,المدرسة المتوسطة الرسمية - غرفة رقم 2,شيعي,640,288,0,1,288
مرجعيون,عديسه ,المدرسة المتوسطة الرسمية - غرفة رقم 3,شيعي,623,310,2,2,308
مرجعيون,عديسه ,المدرسة المتوسطة الرسمية - غرفة رقم 4,شيعي,644,351,6,2,345
مرجعيون,عديسه ,المدرسة المتوسطة الرسمية - غرفة رقم 5,شيعي,643,306,3,1,303
مرجعيون,عديسه ,المدرسة المتوسطة الرسمية - غرفة رقم 6,شيعي,658,320,0,4,320
مرجعيون,عديسه ,المدرسة المتوسطة الرسمية - غرفة رقم 7,شيعي,557,228,4,3,224
مرجعيون,علمان ,بيت جاهز قرب خزان الماء مدخل البلدة - غرفة رقم 1,مختلف,52,23,1,0,22
مرجعيون,عين عرب ,المدرسة المتوسطة الرسمية - غرفة رقم 1,سني,686,351,17,2,334
مرجعيون,قبريخا ,متوسطة الامام موسى الصدر الرسمية - غرفة رقم 1,شيعي,618,287,2,1,285
مرجعيون,قبريخا ,متوسطة الامام موسى الصدر الرسمية - غرفة رقم 2,شيعي,612,312,3,0,309
مرجعيون,قبريخا ,متوسطة الامام موسى الصدر الرسمية - غرفة رقم 3,شيعي,588,322,0,1,322
مرجعيون,قبريخا ,متوسطة الامام موسى الصدر الرسمية - غرفة رقم 4,شيعي,651,381,2,3,379
مرجعيون,قبريخا ,متوسطة الامام موسى الصدر الرسمية - غرفة رقم 5,شيعي,577,285,3,0,282
مرجعيون,قنطره ,مدرسة القنطرة الفنية الرسمية - غرفة رقم 1,شيعي,579,377,4,2,373
مرجعيون,قنطره ,مدرسة القنطرة الفنية الرسمية - غرفة رقم 2,شيعي,521,333,5,10,328
مرجعيون,قنطره ,مدرسة القنطرة الفنية الرسمية - غرفة رقم 3,شيعي,587,394,2,0,392
مرجعيون,قنطره ,مدرسة القنطرة الفنية الرسمية - غرفة رقم 4,شيعي,505,325,1,2,324
مرجعيون,كفركلا ,ثانوية كفركلا الرسمية الثانية - غرفة رقم 1,شيعي,625,339,2,2,337
مرجعيون,كفركلا ,ثانوية كفركلا الرسمية الثانية - غرفة رقم 10,مختلف,2677,363,3,2,360
مرجعيون,كفركلا ,ثانوية كفركلا الرسمية الثانية - غرفة رقم 2,شيعي,634,385,8,1,377
مرجعيون,كفركلا ,ثانوية كفركلا الرسمية الثانية - غرفة رقم 3,شيعي,6044,319,4,1,315
مرجعيون,كفركلا ,ثانوية كفركلا الرسمية الثانية - غرفة رقم 4,شيعي,582,340,6,5,334
مرجعيون,كفركلا ,ثانوية كفركلا الرسمية الثانية - غرفة رقم 5,شيعي,651,356,7,1,349
مرجعيون,كفركلا ,ثانوية كفركلا الرسمية الثانية - غرفة رقم 6,شيعي,668,382,1,2,381
مرجعيون,كفركلا ,ثانوية كفركلا الرسمية الثانية - غرفة رقم 7,شيعي,634,391,2,4,389
مرجعيون,كفركلا ,ثانوية كفركلا الرسمية الثانية - غرفة رقم 8,شيعي,669,363,1,3,362
مرجعيون,كفركلا ,ثانوية كفركلا الرسمية الثانية - غرفة رقم 9,شيعي,674,395,4,4,391
مرجعيون,مجدل سلم ,الثانوية الرسمية - غرفة رقم 1,شيعي,632,367,0,0,367
مرجعيون,مجدل سلم ,الثانوية الرسمية - غرفة رقم 2,شيعي,637,364,4,4,360
مرجعيون,مجدل سلم ,الثانوية الرسمية - غرفة رقم 3,شيعي,647,382,5,0,377
مرجعيون,مجدل سلم ,الثانوية الرسمية - غرفة رقم 4,شيعي,657,350,1,3,349
مرجعيون,مجدل سلم ,الثانوية الرسمية - غرفة رقم 5,شيعي,647,405,1,1,404
مرجعيون,مجدل سلم ,الثانوية الرسمية - غرفة رقم 6,شيعي,661,395,3,7,392
مرجعيون,مجدل سلم ,الثانوية الرسمية - غرفة رقم 7,شيعي,662,401,6,3,395
مرجعيون,مجدل سلم ,الثانوية الرسمية - غرفة رقم 8,شيعي,647,345,1,4,344
مرجعيون,محيبيب ,النادي الحسيني - غرفة رقم 1,شيعي,346,176,2,2,174
مرجعيون,محيبيب ,النادي الحسيني - غرفة رقم 2,شيعي,384,220,4,0,216
